Rank,Release Group,Worldwide,Domestic,Foreign,Year,Domestic %,Foreign %
1,Avengers: Endgame,2797800564,858373000,1939427564,2019,0.306802783245132,0.693197216754868
2,Star Wars: Episode VII - The Force Awakens,2068223624,936662225,1131561399,2015,0.4528824707980417,0.5471175292019583
3,Avengers: Infinity War,2048359754,678815482,1369544272,2018,0.3313946589091205,0.6686053410908794
4,Jurassic World,1670400637,652270625,1018130012,2015,0.39048753368022093,0.6095124663197791
5,The Lion King,1656943394,543638043,1113305351,2019,0.32809693135479556,0.6719030686452044
6,The Avengers,1518812988,623357910,895455078,2012,0.41042440045291473,0.5895755995470853
7,Furious 7,1515047671,353007020,1162040651,2015,0.23300060239490641,0.7669993976050936
8,Frozen II,1450026933,477373578,972653355,2019,0.329217042205105,0.6707829577948949
9,Avengers: Age of Ultron,1402805868,459005868,943800000,2015,0.3272055517235689,0.6727944482764311
10,Black Panther,1346913161,700059566,646853595,2018,0.5197510769589992,0.4802489230410007
11,Harry Potter and the Deathly Hallows: Part 2,1341511219,381011219,960500000,2011,0.2840164238686102,0.7159835761313897
12,Star Wars: Episode VIII - The Last Jedi,1332539889,620181382,712358507,2017,0.465412995978239,0.5345870040217611
13,Jurassic World: Fallen Kingdom,1308467944,417719760,890748184,2018,0.3192434036427567,0.6807565963572433
14,Frozen,1280802282,400738009,880064273,2013,0.31288046143565507,0.6871195385643449
15,Beauty and the Beast,1263521126,504014165,759506961,2017,0.3988965080430321,0.6011034919569679
16,Incredibles 2,1242805359,608581744,634223615,2018,0.48968387494698595,0.510316125053014
17,The Fate of the Furious,1236005118,226008385,1009996733,2017,0.1828539232634472,0.8171460767365528
18,Iron Man 3,1214811252,409013994,805797258,2013,0.33668933616363966,0.6633106638363603
19,Minions,1159398397,336045770,823352627,2015,0.28984494964762314,0.7101550503523768
20,Captain America: Civil War,1153296293,408084349,745211944,2016,0.35384172434862754,0.6461582756513724
21,Aquaman,1148461807,335061807,813400000,2018,0.2917483236776023,0.7082516763223977
22,The Lord of the Rings: The Return of the King,1140444782,377027325,763417457,2003,0.3305967381768423,0.6694032618231577
23,Spider-Man: Far from Home,1131927996,390532085,741395911,2019,0.345014953583673,0.654985046416327
24,Captain Marvel,1128274794,426829839,701444955,2019,0.3783030882811692,0.6216969117188308
25,Transformers: Dark of the Moon,1123794079,352390543,771403536,2011,0.3135721655639725,0.6864278344360275
26,Skyfall,1108561013,304360277,804200736,2012,0.2745543758356943,0.7254456241643057
27,Transformers: Age of Extinction,1104054072,245439076,858614996,2014,0.22230711540729683,0.7776928845927031
28,The Dark Knight Rises,1081041287,448139099,632902188,2012,0.4145439257399981,0.5854560742600019
29,Joker,1074251311,335451311,738800000,2019,0.3122652097931673,0.6877347902068327
30,Star Wars: Episode IX - The Rise of Skywalker,1074144248,515202542,558941706,2019,0.4796399952420543,0.5203600047579457
31,Toy Story 4,1073394593,434038008,639356585,2019,0.4043601587249657,0.5956398412750342
32,Toy Story 3,1066969703,415004880,651964823,2010,0.3889565737744289,0.6110434262255711
33,Rogue One: A Star Wars Story,1056057273,532177324,523879949,2016,0.5039284682810948,0.49607153171890517
34,Aladdin,1050693953,355559216,695134737,2019,0.3384041708670612,0.6615958291329388
35,Pirates of the Caribbean: On Stranger Tides,1045713802,241071802,804642000,2011,0.23053325062644625,0.7694667493735537
36,Despicable Me 3,1034799409,264624300,770175109,2017,0.2557252136969475,0.7442747863030524
37,Finding Dory,1028570889,486295561,542275328,2016,0.47278759898871686,0.5272124010112832
38,Alice in Wonderland,1025467110,334191110,691276000,2010,0.32589159295416115,0.6741084070458389
39,Zootopia,1023784195,341268248,682515947,2016,0.3333400238709487,0.6666599761290513
40,The Hobbit: An Unexpected Journey,1017003568,303003568,714000000,2012,0.29793756633113405,0.7020624336688659
41,Harry Potter and the Deathly Hallows: Part 1,976536918,295983305,680553613,2010,0.30309484418283916,0.6969051558171608
42,Harry Potter and the Sorcerer's Stone,974755371,317575550,657179821,2001,0.32580025660612644,0.6741997433938736
43,Despicable Me 2,970766005,368065385,602700620,2013,0.3791494377679614,0.6208505622320386
44,The Jungle Book,966550600,364001123,602549477,2016,0.3765981036067848,0.6234018963932152
45,Jumanji: Welcome to the Jungle,962077546,404515480,557562066,2017,0.42046036900231326,0.5795396309976868
46,The Hobbit: The Desolation of Smaug,958366855,258366855,700000000,2013,0.2695907664711547,0.7304092335288452
47,The Hobbit: The Battle of the Five Armies,956019788,255119788,700900000,2014,0.26685617934092387,0.7331438206590761
48,The Lord of the Rings: The Two Towers,936689735,339789881,596899854,2002,0.36275606351125433,0.6372439364887457
49,Shrek 2,928760770,441226247,487534523,2004,0.47506985787093486,0.5249301421290652
50,Bohemian Rhapsody,903655259,216428042,687227217,2018,0.23950288546929155,0.7604971145307085
51,Harry Potter and the Goblet of Fire,895921036,290013036,605908000,2005,0.3237037912345659,0.6762962087654341
52,The Lord of the Rings: The Fellowship of the Ring,883726270,313364114,570362156,2001,0.35459409167501604,0.6454059083249839
53,Spectre,880674609,200074609,680600000,2015,0.22718335121207064,0.7728166487879293
54,Spider-Man: Homecoming,880166924,334201140,545965784,2017,0.37970199843592395,0.620298001564076
55,Harry Potter and the Chamber of Secrets,878979634,261988482,616991152,2002,0.2980597864455185,0.7019402135544816
56,Ice Age: Continental Drift,877244782,161321843,715922939,2012,0.18389604168657225,0.8161039583134277
57,The Secret Life of Pets,875457937,368384330,507073607,2016,0.42079043941548044,0.5792095605845196
58,Batman v Superman: Dawn of Justice,873634919,330360194,543274725,2016,0.3781444477724682,0.6218555522275317
59,Finding Nemo,871014978,339714978,531300000,2003,0.3900219704373442,0.6099780295626558
60,Wolf Warrior 2,870325439,2721100,867604339,2017,0.003126531614572282,0.9968734683854277
61,Star Wars: Episode III - Revenge of the Sith,868352530,380270577,488081953,2005,0.437921885250913,0.562078114749087
62,The Hunger Games: Catching Fire,865011746,424668047,440343699,2013,0.490939052520103,0.5090609474798969
63,Guardians of the Galaxy Vol. 2,863756051,389813101,473942950,2017,0.4512999944240043,0.5487000055759956
64,Inside Out,857611174,356461711,501149463,2015,0.4156449004009829,0.5843550995990171
65,Venom,856085151,213515506,642569645,2018,0.24940919224050412,0.7505908077594958
66,Thor: Ragnarok,853977126,315058289,538918837,2017,0.36893059475225337,0.6310694052477467
67,The Twilight Saga: Breaking Dawn - Part 2,829746820,292324737,537422083,2012,0.35230594436023266,0.6476940556397673
68,Inception,828322032,292576195,535745837,2010,0.35321551727118616,0.6467844827288138
69,Wonder Woman,821847012,412563408,409283604,2017,0.501995385973369,0.49800461402663104
70,Spider-Man,821708551,403706375,418002176,2002,0.4913011730359856,0.5086988269640144
71,Fantastic Beasts and Where to Find Them,814037575,234037575,580000000,2016,0.287502177034027,0.7124978229659731
72,Coco,807082196,209726015,597356181,2017,0.2598570703695711,0.7401429296304288
73,Jumanji: The Next Level,796575993,316831246,479744747,2019,0.3977413941471872,0.6022586058528129
74,Harry Potter and the Prisoner of Azkaban,795634069,249541069,546093000,2004,0.31363798852107727,0.6863620114789227
75,Pirates of the Caribbean: Dead Men Tell No Tales,794861794,172558876,622302918,2017,0.21709293024593404,0.782907069754066
76,Mission: Impossible - Fallout,791115104,220159104,570956000,2018,0.27828959766643513,0.7217104023335649
77,Spider-Man 2,788976453,373585825,415390628,2004,0.47350693874256855,0.5264930612574314
78,Fast & Furious 6,788679850,238679850,550000000,2013,0.30263211365169274,0.6973678863483073
79,Deadpool,782612155,363070709,419541446,2016,0.463921633059737,0.536078366940263
80,Guardians of the Galaxy,772776600,333176600,439600000,2014,0.4311421955581988,0.5688578044418011
81,Fast & Furious Presents: Hobbs & Shaw,759056935,173956935,585100000,2019,0.22917508157671992,0.77082491842328
82,Maleficent,758410378,241410378,517000000,2014,0.31831101604466705,0.681688983955333
83,The Amazing Spider-Man,757930663,262030663,495900000,2012,0.34571851462354675,0.6542814853764533
84,The Hunger Games: Mockingjay - Part 1,755356711,337135885,418220826,2014,0.44632672231596815,0.5536732776840319
85,Shrek Forever After,752600867,238736787,513864080,2010,0.31721566831519477,0.6827843316848052
86,Madagascar 3: Europe's Most Wanted,746921274,216391482,530529792,2012,0.2897112313338661,0.7102887686661339
87,Suicide Squad,746846894,325100054,421746840,2016,0.43529678788488074,0.5647032121151193
88,X-Men: Days of Future Past,746045700,233921534,512124166,2014,0.3135485319465014,0.6864514680534985
89,"The Chronicles of Narnia: The Lion, the Witch and the Wardrobe",745013115,291710957,453302158,2005,0.39155143866158654,0.6084485613384135
90,Monsters University,743559607,268492764,475066843,2013,0.3610911102114238,0.6389088897885762
91,The Matrix Reloaded,739412035,281576461,457835574,2003,0.3808113036731949,0.6191886963268052
92,Deadpool 2,734546611,318491426,416055185,2018,0.43358912998919275,0.5664108700108073
93,Ne Zha,726063471,3695533,722367938,2019,0.005089820859476899,0.9949101791405232
94,Gravity,723192705,274092705,449100000,2013,0.37900369169238235,0.6209963083076177
95,Captain America: The Winter Soldier,714421503,259766572,454654931,2014,0.3636040781376089,0.6363959218623911
96,The Twilight Saga: Breaking Dawn - Part 1,712205856,281287133,430918723,2011,0.394952008089077,0.6050479919109231
97,Dawn of the Planet of the Apes,710644566,208545589,502098977,2014,0.29345976734028806,0.7065402326597119
98,The Amazing Spider-Man 2,708982323,202853933,506128390,2014,0.28611987410580336,0.7138801258941967
99,It,700381748,327481748,372900000,2017,0.4675760739555994,0.5324239260444006
100,The Wandering Earth,699856699,5971413,693885286,2019,0.008532336703402763,0.9914676632965972
101,The Twilight Saga: Eclipse,698491347,300531751,397959596,2010,0.4302583736946422,0.5697416263053579
102,Mission: Impossible - Ghost Protocol,694713380,209397903,485315477,2011,0.3014162516921727,0.6985837483078273
103,The Hunger Games,694394724,408010692,286384032,2012,0.5875774655223331,0.4124225344776669
104,Mission: Impossible - Rogue Nation,682714267,195042377,487671890,2015,0.2856866868434727,0.7143133131565274
105,Doctor Strange,677718395,232641920,445076475,2016,0.3432722524817996,0.6567277475182004
106,Interstellar,677463813,188020017,489443796,2014,0.2775351441538915,0.7224648558461085
107,Man of Steel,668045518,291045518,377000000,2013,0.4356671965577052,0.5643328034422948
108,Kung Fu Panda 2,665692281,165249063,500443218,2011,0.24823641150196843,0.7517635884980316
109,The Hunger Games: Mockingjay - Part 2,658344137,281723902,376620235,2015,0.4279280184430351,0.5720719815569649
110,Justice League,657924295,229024295,428900000,2017,0.3481012887660578,0.6518987112339422
111,Big Hero 6,657827828,222527828,435300000,2014,0.33827670178769026,0.6617232982123098
112,Fantastic Beasts: The Crimes of Grindelwald,654855901,159555901,495300000,2018,0.24365039813545178,0.7563496018645482
113,Pirates of the Caribbean: The Curse of the Black Pearl,654264015,305413918,348850097,2003,0.4668053125312111,0.5331946874687888
114,Star Wars: Episode II - Attack of the Clones,645256452,302191252,343065200,2002,0.4683273620331037,0.5316726379668963
115,Thor: The Dark World,644783140,206362140,438421000,2013,0.32004890822672566,0.6799510917732744
116,Moana,643331111,248757044,394574067,2016,0.38667031602642327,0.6133296839735767
117,Sing,634151679,270395425,363756254,2016,0.42638919670825315,0.5736108032917469
118,The Incredibles,631442092,261441092,370001000,2004,0.4140381126192012,0.5859618873807988
119,The Martian,630161890,228433663,401728227,2015,0.36249996488997455,0.6375000351100255
120,Fast Five,626137675,209837675,416300000,2011,0.33513024911014977,0.6648697508898502
121,Men in Black 3,624026776,179020854,445005922,2012,0.2868800841328001,0.7131199158671999
122,Iron Man 2,623933331,312433331,311500000,2010,0.5007479412892594,0.4992520587107407
123,Ant-Man and the Wasp,622674139,216648740,406025399,2018,0.3479327732285988,0.6520672267714012
124,How to Train Your Dragon 2,621537519,177002924,444534595,2014,0.2847823640393944,0.7152176359606056
125,Logan,619021436,226277068,392744368,2017,0.36553995522701094,0.6344600447729891
126,The Passion of the Christ,611486736,370274604,241212132,2004,0.6055317019991747,0.39446829800082533
127,Life of Pi,609016565,124987023,484029542,2012,0.20522762463776334,0.7947723753622367
128,Transformers: The Last Knight,605425157,130168683,475256474,2017,0.21500375644284633,0.7849962435571537
129,War of the Worlds,603873119,234280354,369592765,2005,0.38796287933459084,0.6120371206654092
130,Tangled,592461732,200821936,391639796,2010,0.33896186901738995,0.66103813098261
131,The Croods,587204668,187168425,400036243,2013,0.3187447838885368,0.6812552161114632
132,The Hangover Part II,586764305,254464305,332300000,2011,0.43367379854505633,0.5663262014549436
133,Ready Player One,582890172,137690172,445200000,2018,0.23621975221774713,0.7637802477822528
134,Operation Red Sea,579330426,1543547,577786879,2018,0.0026643637736368433,0.9973356362263631
135,Fifty Shades of Grey,569651467,166167230,403484237,2015,0.2916998193212763,0.7083001806787237
136,Kong: Skull Island,566652812,168052812,398600000,2017,0.29657103686975084,0.7034289631302492
137,The Smurfs,563749323,142614158,421135165,2011,0.2529744199799243,0.7470255800200757
138,King Kong,562363449,218080025,344283424,2005,0.38779196156469975,0.6122080384353003
139,Cars 2,559852396,191452396,368400000,2011,0.3419694143811434,0.6580305856188566
140,Puss in Boots,554987477,149260504,405726973,2011,0.26894391348581725,0.7310560865141827
141,The Mermaid,553810228,3232685,550577543,2016,0.005837170995693492,0.9941628290043065
142,The Day After Tomorrow,552639571,186740799,365898772,2004,0.3379070352528194,0.6620929647471806
143,Ted,549368315,218815487,330552828,2012,0.398303799155217,0.6016962008447829
144,American Sniper,547426372,350126372,197300000,2014,0.639586234621521,0.3604137653784791
145,Mission: Impossible II,546388108,215409889,330978219,2000,0.3942433699527004,0.6057566300472996
146,Detective Chinatown 2,544185156,1983984,542201172,2018,0.0036457885301083076,0.9963542114698917
147,X-Men: Apocalypse,543934105,155442489,388491616,2016,0.285774485495812,0.7142255145041879
148,Sherlock Holmes: A Game of Shadows,543848418,186848418,357000000,2011,0.3435670893134785,0.6564329106865214
149,Despicable Me,543113985,251513985,291600000,2010,0.4630961307321151,0.5369038692678849
150,Cinderella,542351353,201151353,341200000,2015,0.3708875286976559,0.6291124713023442
151,Madagascar,542063846,193595521,348468325,2005,0.35714523746341126,0.6428547625365887
152,World War Z,540007876,202359711,337648165,2013,0.37473473997997764,0.6252652600200224
153,Brave,538983207,237283207,301700000,2012,0.4402423005360907,0.5597576994639093
154,The Revenant,532950503,183637894,349312609,2015,0.34456838480552104,0.6554316151944789
155,The Meg,530243742,145443742,384800000,2018,0.2742960085703378,0.7257039914296621
156,Ralph Breaks the Internet,529323962,201091711,328232251,2018,0.3799029052835511,0.6200970947164489
157,"Monsters, Inc.",528773250,255873250,272900000,2001,0.48389976232723575,0.5161002376727643
158,Hotel Transylvania 3: Summer Vacation,528583774,167510016,361073758,2018,0.31690343941583043,0.6830965605841696
159,The Boss Baby,527965936,175003033,352962903,2017,0.331466522870521,0.6685334771294791
160,Dunkirk,525245546,188045546,337200000,2017,0.3580145465907482,0.6419854534092517
161,Godzilla,524976069,200676069,324300000,2014,0.38225755582013016,0.6177424441798699
162,Meet the Fockers,522657936,279261160,243396776,2004,0.5343096139269183,0.46569038607308166
163,How to Train Your Dragon: The Hidden World,521799505,160799505,361000000,2019,0.3081633912243746,0.6918366087756255
164,Kung Fu Panda 3,521170825,143528619,377642206,2016,0.2753964959569638,0.7246035040430362
165,Ant-Man,519311965,180202163,339109802,2015,0.3470017545234106,0.6529982454765894
166,The Grinch,511595957,270620950,240975007,2018,0.5289739809261237,0.4710260190738763
167,Rio 2,498781117,131538435,367242682,2014,0.2637197570572825,0.7362802429427175
168,Troy,497409852,133378256,364031596,2004,0.268145585504004,0.731854414495996
169,How to Train Your Dragon,494878759,217581231,277297528,2010,0.4396657303289107,0.5603342696710892
170,Oz The Great and Powerful,493311825,234911825,258400000,2013,0.47619337930932426,0.5238066206906757
171,Clash of the Titans,493214993,163214888,330000105,2010,0.33092037005452507,0.6690796299454749
172,Maleficent: Mistress of Evil,491730089,113929605,377800484,2019,0.23169134358178353,0.7683086564182164
173,War for the Planet of the Apes,490719763,146880162,343839601,2017,0.2993157665019495,0.7006842334980505
174,Shrek,487769799,267665011,220104788,2001,0.5487527344840799,0.45124726551592015
175,Mr. & Mrs. Smith,487287646,186336279,300951367,2005,0.38239483502112015,0.6176051649788799
176,Teenage Mutant Ninja Turtles,485004754,191204754,293800000,2014,0.39423274189184543,0.6057672581081546
177,Bruce Almighty,484592874,242829261,241763613,2003,0.5010995291688916,0.49890047083110844
178,Rio,483866518,143619809,340246709,2011,0.29681700150205476,0.7031829984979453
179,Rise of the Planet of the Apes,481800873,176760185,305040688,2011,0.3668739408863628,0.6331260591136372
180,Charlie and the Chocolate Factory,474968763,206459076,268509687,2005,0.43467927173981336,0.5653207282601866
181,Hotel Transylvania 2,474800000,169700110,305099890,2015,0.3574138795282224,0.6425861204717775
182,San Andreas,473990832,155190832,318800000,2015,0.32741315131597315,0.6725868486840269
183,It Chapter Two,473093228,211593228,261500000,2019,0.44725482310222375,0.5527451768977762
184,Wreck-It Ralph,471222889,189422889,281800000,2012,0.40198151113156133,0.5980184888684387
185,The Lego Movie,468060692,257760692,210300000,2014,0.5506992926464331,0.44930070735356686
186,Bumblebee,467989645,127195589,340794056,2018,0.2717914602576303,0.7282085397423698
187,Star Trek Into Darkness,467365246,228778661,238586585,2013,0.4895072172311246,0.5104927827688753
188,Gladiator,460583960,187705427,272878533,2000,0.4075379155626696,0.5924620844373304
189,Lucy,458863600,126663600,332200000,2014,0.27603758502526676,0.7239624149747332
190,The Last Samurai,454627263,111127263,343500000,2003,0.24443598535356645,0.7555640146464335
191,Ocean's Eleven,450717150,183417150,267300000,2001,0.4069451317749946,0.5930548682250054
192,"My People, My Country",450064993,2356683,447708310,2019,0.005236317057878794,0.9947636829421213
193,Thor,449326618,181030624,268295994,2011,0.40289316668081304,0.597106833319187
194,Pearl Harbor,449220945,198542554,250678391,2001,0.44197083018914,0.55802916981086
195,La La Land,446486224,151101803,295384421,2016,0.3384243340058797,0.6615756659941203
196,Men in Black II,441818803,190418803,251400000,2002,0.43098845433248795,0.569011545667512
197,Les Misérables,441809770,148809770,293000000,2012,0.33681864934765926,0.6631813506523407
198,Terminator Genisys,440603537,89760956,350842581,2015,0.20372273134974855,0.7962772686502514
199,Warcraft,439048914,47365290,391683624,2016,0.10788157877097038,0.8921184212290296
200,A Star Is Born,436188866,215288866,220900000,2018,0.4935679995096436,0.5064320004903564
201,The Greatest Showman,434993183,174340174,260653009,2017,0.4007882900546513,0.5992117099453488
202,Terminator 3: Rise of the Machines,433371112,150371112,283000000,2003,0.34698000821060726,0.6530199917893927
203,The Mummy Returns,433013274,202019785,230993489,2001,0.46654409259518453,0.5334559074048155
204,Pokémon Detective Pikachu,433005346,144105346,288900000,2019,0.3328026947731957,0.6671973052268043
205,Die Another Day,431971116,160942139,271028977,2002,0.37257615854111875,0.6274238414588812
206,The Secret Life of Pets 2,430051293,158874395,271176898,2019,0.36943126921374003,0.63056873078626
207,Cast Away,429632142,233632142,196000000,2000,0.5437957712204875,0.4562042287795125
208,Rampage,428028233,101028233,327000000,2018,0.2360317035441912,0.7639682964558088
209,The Matrix Revolutions,427343298,139313948,288029350,2003,0.32600007687496246,0.6739999231250375
210,The Intouchables,426588510,10198820,416389690,2011,0.023907863810021513,0.9760921361899785
211,Django Unchained,425368238,162805434,262562804,2012,0.38273998727662406,0.6172600127233759
212,The King's Speech,423999102,135453143,288545959,2010,0.3194656365097679,0.6805343634902321
213,Bad Boys for Life,419074646,204417855,214656791,2020,0.48778387562009656,0.5122161243799034
214,The Captain,416953262,706572,416246690,2019,0.001694607200362903,0.9983053927996371
215,The Chronicles of Narnia: The Voyage of the Dawn Treader,415686217,104386950,311299267,2010,0.25111958427045944,0.7488804157295406
216,Jason Bourne,415484914,162434410,253050504,2016,0.39095140287091146,0.6090485971290885
217,The Wolverine,414828246,132556852,282271394,2013,0.3195463502743253,0.6804536497256747
218,Kingsman: The Secret Service,414351546,128261724,286089822,2015,0.3095480763573644,0.6904519236426355
219,Pacific Rim,411002906,101802906,309200000,2013,0.24769388370212642,0.7523061162978736
220,Kingsman: The Golden Circle,410902662,100234838,310667824,2017,0.24393815681826855,0.7560618431817314
221,The Mummy,409231607,80227895,329003712,2017,0.196045206742792,0.803954793257208
222,Ice Age: Collision Course,408579038,64063008,344516030,2016,0.15679465180981703,0.843205348190183
223,Signs,408247917,227966634,180281283,2002,0.5584024425040728,0.44159755749592716
224,X2: X-Men United,407711549,214949694,192761855,2003,0.5272102164562427,0.4727897835437573
225,Alita: Battle Angel,404852543,85710210,319142333,2019,0.21170722892062951,0.7882927710793705
226,Prometheus,403354469,126477084,276877385,2012,0.3135631156227502,0.6864368843772498
227,TRON: Legacy,400062763,172062763,228000000,2010,0.4300894232438224,0.5699105767561776
228,Mission: Impossible III,398479497,134029801,264449696,2005,0.33635306711903423,0.6636469328809658
229,Snow White and the Huntsman,396592829,155332381,241260448,2012,0.39166714484391246,0.6083328551560876
230,Mamma Mia! Here We Go Again,395044706,120634935,274409771,2018,0.3053703369967449,0.6946296630032551
231,Solo: A Star Wars Story,392924807,213767512,179157295,2018,0.5440417815106289,0.4559582184893712
232,The Wolf of Wall Street,392000694,116900694,275100000,2013,0.2982155281592435,0.7017844718407565
233,Independence Day: Resurgence,389681935,103144286,286537649,2016,0.26468839516514925,0.7353116048348508
234,Monster Hunt,387053506,32766,387020740,2015,8.465496240718718e-05,0.9999153450375928
235,Godzilla: King of the Monsters,386600138,110500138,276100000,2019,0.2858253971963145,0.7141746028036855
236,Home,386041607,177397510,208644097,2015,0.45952950869360565,0.5404704913063944
237,Cars 3,383930656,152901115,231029541,2017,0.3982519046356121,0.6017480953643879
238,Ice Age,383257136,176387405,206869731,2002,0.4602325395449388,0.5397674604550612
239,Fifty Shades Darker,381545846,114581250,266964596,2017,0.3003079477898444,0.6996920522101556
240,Taken 2,376141306,139854287,236287019,2012,0.3718131584304118,0.6281868415695883
241,G.I. Joe: Retaliation,375740705,122523060,253217645,2013,0.3260840743884802,0.6739159256115198
242,Spider-Man: Into the Spider-Verse,375540831,190241310,185299521,2018,0.5065795628491859,0.49342043715081413
243,Mad Max: Fury Road,374736354,153636354,221100000,2015,0.4099851865453118,0.5900148134546882
244,1917,374717445,159227644,215489801,2019,0.4249272248320331,0.5750727751679668
245,Shark Tale,374583879,160861908,213721971,2004,0.42944162047080514,0.5705583795291949
246,Once Upon a Time... in Hollywood,374343626,142502728,231840898,2019,0.38067357930651663,0.6193264206934834
247,What Women Want,374111707,182811707,191300000,2000,0.4886554031307018,0.5113445968692982
248,The Adventures of Tintin,373993951,77591831,296402120,2011,0.20746814431766036,0.7925318556823396
249,Penguins of Madagascar,373515621,83850911,289664710,2014,0.22449104210289508,0.775508957897105
250,Fifty Shades Freed,371985018,100407760,271577258,2018,0.26992420431298125,0.7300757956870187
251,Batman Begins,371853783,205343774,166510009,2005,0.552216444709398,0.44778355529060193
252,Hitch,371594210,179495555,192098655,2005,0.48304185094810814,0.5169581490518919
253,Captain America: The First Avenger,370569774,176654505,193915269,2011,0.4767105074252494,0.5232894925747505
254,Edge of Tomorrow,370541256,100206256,270335000,2014,0.2704321162013873,0.7295678837986127
255,Gone Girl,369330363,167767189,201563174,2014,0.4542469447604014,0.5457530552395986
256,Jurassic Park III,368780809,181171875,187608934,2001,0.49127251358679025,0.5087274864132098
257,My Big Fat Greek Wedding,368744044,241438208,127305836,2002,0.6547582582784713,0.34524174172152866
258,Shazam!,365971656,140371656,225600000,2019,0.3835588185550632,0.6164411814449369
259,The Nun,365550119,117450119,248100000,2018,0.32129689718415877,0.6787031028158412
260,Night at the Museum: Secret of the Tomb,363204635,113746621,249458014,2014,0.313175025973994,0.6868249740260061
261,Ocean's Twelve,362744280,125544280,237200000,2004,0.34609582265501193,0.6539041773449881
262,Planet of the Apes,362211740,180011740,182200000,2001,0.4969793082907804,0.5030206917092196
263,The Hangover Part III,362000072,112200072,249800000,2013,0.3099448886297459,0.6900551113702541
264,Monster Hunt 2,361682618,706153,360976465,2018,0.0019524106629862981,0.9980475893370137
265,Noah,359200044,101200044,258000000,2014,0.28173728174710355,0.7182627182528964
266,The Karate Kid,359126022,176591618,182534404,2010,0.4917260437340294,0.5082739562659706
267,Hotel Transylvania,358375603,148313048,210062555,2011,0.4138480598524448,0.5861519401475552
268,Minority Report,358372926,132072926,226300000,2002,0.3685348875936013,0.6314651124063987
269,Your Name.,357986087,5017246,352968841,2016,0.014015198305737508,0.9859848016942625
270,The Legend of Tarzan,356700357,126643061,230057296,2016,0.3550404660794887,0.6449595339205113
271,The Great Gatsby,353641895,144840419,208801476,2013,0.40956804340164504,0.5904319565983549
272,Dumbo,353284621,114766307,238518314,2019,0.32485508900768145,0.6751449109923185
273,"I, Robot",353133898,144801023,208332875,2004,0.4100456620564928,0.5899543379435072
274,Murder on the Orient Express,352789811,102826543,249963268,2017,0.29146687289106543,0.7085331271089346
275,X-Men: First Class,352616690,146408305,206208385,2011,0.41520526155469273,0.5847947384453073
276,The Angry Birds Movie,352333929,107509366,244824563,2016,0.3051348653964007,0.6948651346035993
277,Catch Me If You Can,352114312,164615351,187498961,2002,0.4675054247723961,0.5324945752276039
278,Now You See Me,351723989,117723989,234000000,2013,0.3347056006464205,0.6652943993535795
279,Hannibal,351692268,165092268,186600000,2001,0.46942251229702897,0.5305774877029711
280,Peter Rabbit,351266433,115253424,236013009,2018,0.3281082767165515,0.6718917232834485
281,Dinosaur,349822765,137748063,212074702,2000,0.39376529140406286,0.6062347085959372
282,Mary Poppins Returns,349537494,171958438,177579056,2018,0.4919599211865952,0.5080400788134047
283,The Lorax,348840316,214030500,134809816,2012,0.6135486358176558,0.3864513641823441
284,The Maze Runner,348319861,102427862,245891999,2014,0.2940626517992323,0.7059373482007677
285,The Smurfs 2,347545360,71017784,276527576,2013,0.2043410506185437,0.7956589493814563
286,National Treasure,347512318,173008894,174503424,2004,0.4978496733459675,0.5021503266540325
287,Rush Hour 2,347325802,226164286,121161516,2001,0.6511588966258257,0.3488411033741743
288,Trolls,346864462,153707064,193157398,2016,0.44313292608223437,0.5568670739177656
289,xXx: Return of Xander Cage,346118277,44898413,301219864,2017,0.12971985585147242,0.8702801441485276
290,How the Grinch Stole Christmas,345141403,260044825,85096578,2000,0.7534443064195344,0.24655569358046564
291,Titanic 2012 3D Release,343550770,57884114,285666656,2012,0.1684878016719334,0.8315121983280667
292,Star Trek Beyond,343471816,158848340,184623476,2016,0.462478528369268,0.537521471630732
293,Alvin and the Chipmunks: Chipwrecked,342695435,133110742,209584693,2011,0.3884228630007867,0.6115771369992133
294,A Quiet Place,340939361,188024361,152915000,2018,0.5514891576276522,0.44851084237234784
295,300: Rise of an Empire,337580051,106580051,231000000,2014,0.31571785916935,0.68428214083065
296,Journey 2: The Mysterious Island,335260290,103860290,231400000,2012,0.30979001420060814,0.6902099857993919
297,The Great Wall,334933831,45540830,289393001,2016,0.13596963276008986,0.8640303672399101
298,Now You See Me 2,334897606,65075540,269822066,2016,0.19431473630778956,0.8056852636922105
299,Fantastic Four,333535934,154696080,178839854,2005,0.46380633758040596,0.5361936624195941
300,The Good Dinosaur,332207671,123087120,209120551,2015,0.3705125761530052,0.6294874238469947
301,22 Jump Street,331333876,191719337,139614539,2014,0.5786288420445123,0.4213711579554878
302,Meet the Parents,330444045,166244045,164200000,2000,0.5030928761327806,0.49690712386721936
303,Black Swan,329398046,106954678,222443368,2010,0.32469736629828094,0.6753026337017191
304,The Perfect Storm,328718434,182618434,146100000,2000,0.5555466779815579,0.44445332201844207
305,John Wick: Chapter 3 - Parabellum,326709727,171015687,155694040,2019,0.5234484096030603,0.47655159039693973
306,Taken 3,326479141,89256424,237222717,2015,0.27339089329446625,0.7266091067055338
307,The SpongeBob Movie: Sponge Out of Water,325186032,162994032,162192000,2015,0.5012331894993571,0.4987668105006429
308,Megamind,321885765,148415853,173469912,2010,0.4610823749848024,0.5389176250151976
309,Green Book,321752656,85080171,236672485,2018,0.26442725308847176,0.7355727469115282
310,Robin Hood,321669741,105269730,216400011,2010,0.327260281532045,0.672739718467955
311,The Conjuring 2,320392818,102470008,217922810,2016,0.31982617038562955,0.6801738296143705
312,The Last Airbender,319713881,131772187,187941694,2010,0.4121566026093187,0.5878433973906814
313,The Conjuring,319494638,137400141,182094497,2013,0.4300546070510266,0.5699453929489734
314,The Expendables 2,314975955,85028192,229947763,2012,0.26995137454222495,0.730048625457775
315,Chicken Little,314432837,135386665,179046172,2005,0.4305741928601433,0.5694258071398567
316,A Beautiful Mind,313542341,170742341,142800000,2001,0.5445591190505272,0.45544088094947277
317,Maze Runner: The Scorch Trials,312296056,81697192,230598864,2015,0.2616017411375826,0.7383982588624174
318,Resident Evil: The Final Chapter,312242626,26830068,285412558,2016,0.085926986791355,0.914073013208645
319,The Lego Batman Movie,311950384,175750384,136200000,2017,0.5633921066114155,0.4366078933885845
320,Little Fockers,310650585,148438600,162211985,2010,0.47783138731253316,0.5221686126874668
321,Knives Out,309232797,165363234,143869563,2019,0.5347532202413834,0.4652467797586166
322,The Ex-File 3: The Return of The Exes,307592427,838959,306753468,2017,0.002727502130603495,0.9972724978693965
323,The Fault in Our Stars,307166834,124872350,182294484,2014,0.40652940414784494,0.593470595852155
324,Rise of the Guardians,306941670,103412758,203528912,2012,0.33691338813657984,0.6630866118634202
325,Chicago,306776732,170687518,136089214,2002,0.556390039385386,0.443609960614614
326,Sonic the Hedgehog,306766470,146066470,160700000,2020,0.47614874598257106,0.5238512540174289
327,Annabelle: Creation,306515884,102092201,204423683,2017,0.33307311734617967,0.6669268826538203
328,Wonder,305937718,132422809,173514909,2017,0.43284237676114196,0.5671576232388581
329,Skyscraper,304868961,68420120,236448841,2018,0.22442468323300382,0.7755753167669962
330,A Good Day to Die Hard,304654182,67349198,237304984,2013,0.22106769569964413,0.7789323043003559
331,Dangal,303723636,12391761,291331875,2016,0.04079946217949267,0.9592005378205073
332,Passengers,303144152,100014699,203129453,2016,0.3299245535173642,0.6700754464826357
333,Battleship,303025485,65422625,237602860,2012,0.21589809517176417,0.7841019048282358
334,Wrath of the Titans,301970083,83670083,218300000,2012,0.27708070338875257,0.7229192966112474
335,Resident Evil: Afterlife,300228084,60128566,240099518,2010,0.20027628727764188,0.7997237127223581
336,Van Helsing,300157638,120177084,179980554,2004,0.4003798963796483,0.5996201036203517
337,Alice Through the Looking Glass,299457024,77041381,222415643,2016,0.257270241889534,0.7427297581104659
338,Real Steel,299268508,85468508,213800000,2011,0.28559138604720813,0.7144086139527919
339,Ocean's 8,297718711,140218711,157500000,2018,0.47097715333048046,0.5290228466695195
340,The Divergent Series: Insurgent,297002527,130179072,166823455,2015,0.4383096444159211,0.5616903555840789
341,Austin Powers in Goldmember,296938801,213307889,83630912,2002,0.7183564030084435,0.2816435969915565
342,Miss Peregrine's Home for Peculiar Children,296482446,87242834,209239612,2016,0.29425969455203427,0.7057403054479657
343,X-Men,296339528,157299718,139039810,2000,0.5308090994867212,0.46919090051327883
344,Ferdinand,296069199,84410380,211658819,2017,0.28510355107894897,0.7148964489210511
345,Shutter Island,294804195,128012934,166791261,2010,0.4342303677191568,0.5657696322808432
346,Salt,293503354,118311368,175191986,2010,0.4031005655901295,0.5968994344098705
347,What Lies Beneath,291420351,155464351,135956000,2000,0.533471154181679,0.46652884581832105
348,Pacific Rim: Uprising,290930148,59874525,231055623,2018,0.20580378283793402,0.794196217162066
349,Sex and the City 2,290745055,95347692,195397363,2010,0.3279426093764518,0.6720573906235482
350,The Bourne Supremacy,290633422,176241941,114391481,2004,0.6064063100079384,0.39359368999206157
351,Divergent,288885818,150947895,137937923,2014,0.5225174985917792,0.47748250140822074
352,Wedding Crashers,288467645,209255921,79211724,2005,0.7254051697894923,0.2745948302105077
353,Bridesmaids,288383523,169106725,119276798,2011,0.5863952393701772,0.4136047606298228
354,Maze Runner: The Death Cure,288175335,58032443,230142892,2018,0.2013789382772818,0.7986210617227182
355,American Pie 2,287553595,145103595,142450000,2001,0.5046140876798985,0.4953859123201016
356,Pitch Perfect 2,287144079,184296230,102847849,2015,0.6418249355578737,0.35817506444212627
357,Oblivion,286168572,89107235,197061337,2013,0.3113802273158074,0.6886197726841926
358,Elysium,286140700,93050117,193090583,2013,0.3251900795657521,0.6748099204342479
359,The Polar Express,286000505,162775358,123225147,2004,0.5691436034352457,0.43085639656475433
360,John Carter,284139100,73078100,211061000,2012,0.2571912841280908,0.7428087158719092
361,Turbo,282570682,83028128,199542554,2013,0.29383136074959115,0.7061686392504088
362,Bridget Jones's Diary,281929795,71543427,210386368,2001,0.25376327110087815,0.7462367288991218
363,The Tourist,278780441,67631157,211149284,2010,0.24259649191099458,0.7574035080890055
364,Split,278454358,138291365,140162993,2017,0.4966392553281569,0.5033607446718431
365,Scary Movie,278019771,157019771,121000000,2000,0.5647791537818366,0.43522084621816337
366,xXx,277448382,142109382,135339000,2002,0.5122011560334131,0.4877988439665869
367,The Bourne Legacy,276144750,113203870,162940880,2012,0.4099439514964525,0.5900560485035475
368,Mr. Peabody & Sherman,275698039,111506430,164191609,2014,0.4044512989807664,0.5955487010192336
369,Scooby-Doo,275650703,153294164,122356539,2002,0.556117442588202,0.44388255741179805
370,Lincoln,275293450,182207973,93085477,2012,0.6618681737614898,0.33813182623851024
371,Spirited Away,274925095,10055859,264869236,2001,0.03657672283426873,0.9634232771657313
372,Lara Croft: Tomb Raider,274703340,131168070,143535270,2001,0.4774898987394911,0.5225101012605089
373,Tomb Raider,274650803,58250803,216400000,2018,0.21209041577060309,0.7879095842293969
374,The Expendables,274470394,103068524,171401870,2010,0.3755178199656754,0.6244821800343245
375,Cloudy With a Chance of Meatballs 2,274325949,119793567,154532382,2013,0.43668332302023677,0.5633166769797632
376,Bad Boys II,273339556,138608444,134731112,2003,0.5070925190205547,0.4929074809794452
377,Lilo & Stitch,273144151,145794338,127349813,2002,0.5337633534023578,0.46623664659764213
378,Grown Ups,271430189,162001186,109429003,2010,0.5968429178671795,0.40315708213282053
379,Neighbors,270665134,150157400,120507734,2014,0.5547718606416444,0.44522813935835565
380,We're the Millers,269994119,150394119,119600000,2012,0.5570273884373015,0.4429726115626985
381,Epic,268426634,107518682,160907952,2013,0.4005514668861064,0.5994485331138936
382,Exodus: Gods and Kings,268175631,65014513,203161118,2014,0.24243259075243864,0.7575674092475614
383,Paddington,268047808,76271832,191775976,2014,0.2845456285171338,0.7154543714828662
384,Something's Gotta Give,265328738,124728738,140600000,2003,0.4700913249736257,0.5299086750263743
385,Bridget Jones: The Edge of Reason,265126918,40226215,224900703,2004,0.15172437149516443,0.8482756285048355
386,Charlie's Angels,264105545,125305545,138800000,2000,0.47445253373987284,0.5255474662601272
387,Robots,262511490,128200012,134311478,2005,0.48835962189693105,0.511640378103069
388,Knight and Day 2010 Re-release,261930436,76423035,185507401,2010,0.2917684411444266,0.7082315588555734
389,Terminator: Dark Fate,261119292,62253077,198866215,2019,0.23840856998034446,0.7615914300196556
390,The Lone Ranger,260502115,89302115,171200000,2013,0.34280763900899613,0.6571923609910039
391,Super 8,260095986,127004179,133091807,2011,0.4882973434276683,0.5117026565723317
392,Xun long jue,259368448,1243810,258124638,2015,0.004795533186827721,0.9952044668131723
393,Blade Runner 2049,259239658,92054159,167185499,2017,0.35509288860425825,0.6449071113957418
394,Charlie's Angels: Full Throttle,259175788,100830111,158345677,2003,0.38904139841951596,0.6109586015804841
395,Kung Fu Yoga,257743016,362657,257380359,2017,0.0014070487946800467,0.99859295120532
396,Parasite,257355036,53369749,203985287,2019,0.20737790808181425,0.7926220919181858
397,Annabelle,257047661,84273813,172773848,2014,0.3278528684997449,0.6721471315002551
398,The Village,256697520,114197520,142500000,2003,0.44487192552541993,0.55512807447458
399,Lost in Hong Kong,256283912,1302281,254981631,2015,0.005081399725161055,0.9949186002748389
400,Erin Brockovich,256271286,125595205,130676081,2000,0.4900869190627935,0.5099130809372066
401,Halloween,255485178,159342015,96143163,2018,0.6236839892136522,0.37631601078634785
402,Get Out,255407969,176040665,79367304,2017,0.6892528282858708,0.31074717171412924
403,Us,255184580,175084580,80100000,2019,0.6861095603817441,0.3138904396182559
404,Baahubali 2: The Conclusion,254158390,20186659,233971731,2017,0.07942550706274147,0.9205744929372586
405,Men in Black: International,253890701,80001807,173888894,2019,0.31510333653377876,0.6848966634662212
406,X-Men: Dark Phoenix,252442974,65845974,186597000,2019,0.26083504308580996,0.73916495691419
407,True Grit,252276927,171243005,81033922,2010,0.6787898007018296,0.32121019929817046
408,American Hustle,251171807,150117807,101054000,2013,0.5976698133162692,0.4023301866837308
409,Brother Bear,250397798,85336277,165061521,2003,0.34080282527085165,0.6591971747291484
410,The Ring,249348933,129128133,120220800,2002,0.5178611813029094,0.48213881869709063
411,Unbreakable,248118121,95011339,153106782,2000,0.3829278515292319,0.6170721484707681
412,Journey to the West: The Demons Strike Back,247585244,880346,246704898,2017,0.0035557288704976295,0.9964442711295024
413,Glass,246999039,111048468,135950571,2019,0.44959068848846817,0.5504093115115318
414,Grown Ups 2,246984278,133668525,113315753,2013,0.5412025659382255,0.4587974340617746
415,The Peanuts Movie,246233113,130178411,116054702,2015,0.5286795484732388,0.47132045152676116
416,Rango,245724603,123477607,122246996,2011,0.5025040451484624,0.4974959548515376
417,Teenage Mutant Ninja Turtles: Out of the Shadows,245623848,82051601,163572247,2016,0.3340538863311025,0.6659461136688974
418,Dark Shadows,245527149,79727149,165800000,2012,0.3247182616045446,0.6752817383954554
419,Hulk,245285165,132177234,113107931,2003,0.5388717006183394,0.4611282993816605
420,The Bravest,245179562,290217,244889345,2019,0.0011836916488169597,0.9988163083511831
421,Love Actually,244931766,59696144,185235622,2003,0.24372560968674026,0.7562743903132597
422,Pixels,244874809,78747585,166127224,2015,0.3215830379677805,0.6784169620322195
423,Hercules,244819862,72688614,172131248,2014,0.29690652304999665,0.7030934769500033
424,After Earth,243611982,60522097,183089885,2013,0.24843645416422908,0.7515635458357709
425,8 Mile,242875078,116750901,126124177,2002,0.48070350388111865,0.5192964961188813
426,Daddy's Home,242786137,150357137,92429000,2015,0.6192986916711806,0.38070130832881943
427,RoboCop,242688965,58607007,184081958,2014,0.24149020125410317,0.7585097987458969
428,Alien: Covenant,240891763,74262031,166629732,2017,0.3082796608533269,0.6917203391466731
429,Sully,240797623,125070033,115727590,2016,0.5193989518742052,0.48060104812579485
430,Assassin's Creed,240697856,54647948,186049908,2016,0.2270396126835463,0.7729603873164537
431,Resident Evil: Retribution,240159255,42345531,197813724,2012,0.17632271136084263,0.8236772886391573
432,Planes,239258712,90288712,148970000,2013,0.37736854489127236,0.6226314551087276
433,Crazy Rich Asians,238532921,174532921,64000000,2018,0.7316932198218459,0.2683067801781541
434,Gulliver's Travels,237382724,42779261,194603463,2010,0.1802121918526809,0.8197878081473191
435,Gone in 60 Seconds,237202299,101648571,135553728,2000,0.4285311374659147,0.5714688625340854
436,Silver Linings Playbook,236412453,132092958,104319495,2012,0.5587394247797937,0.44126057522020634
437,2 Fast 2 Furious,236350661,127154901,109195760,2003,0.5379925762086191,0.4620074237913809
438,Hidden Figures,235956898,169607287,66349611,2016,0.7188062245164792,0.2811937754835207
439,A.I. Artificial Intelligence,235926552,78616689,157309863,2001,0.33322527004082186,0.6667747299591782
440,Spy,235666219,110825712,124840507,2015,0.47026558354551445,0.5297344164544856
441,Howl's Moving Castle,235347345,4711096,230636249,2004,0.020017629686878344,0.9799823703131216
442,American Reunion,234989584,57011521,177978063,2012,0.24261297045404362,0.7573870295459564
443,Alvin and the Chipmunks: The Road Chip,234798636,85886987,148911649,2015,0.3657899741802589,0.6342100258197412
444,The Imitation Game,233555708,91125683,142430025,2014,0.39016679909188945,0.6098332009081106
445,American Wedding,232722935,104565114,128157821,2003,0.4493115987902095,0.5506884012097906
446,The Girl with the Dragon Tattoo,232617430,102515793,130101637,2011,0.44070555246010584,0.5592944475398941
447,Argo,232325503,136025503,96300000,2012,0.5854953556261105,0.4145046443738895
448,Annabelle Comes Home,231252591,74152591,157100000,2019,0.32065626023623667,0.6793437397637634
449,Constantine,230884728,75976178,154908550,2005,0.32906541137705736,0.6709345886229426
450,The Heat,229930771,159582188,70348583,2013,0.6940445043782331,0.30595549562176694
451,Ghostbusters,229147509,128350574,100796935,2016,0.5601220565744837,0.43987794342551634
452,Goodbye Mr. Loser,228122928,1293626,226829302,2015,0.005670740820931423,0.9943292591790686
453,Paddington 2,227978523,40891591,187086932,2017,0.17936597913655225,0.8206340208634477
454,The Green Hornet,227817248,98780042,129037206,2011,0.4335933423267408,0.5664066576732593
455,Youth,227091290,1891956,225199334,2017,0.00833125744276674,0.9916687425572333
456,Baby Driver,226945087,107825862,119119225,2017,0.47511873213628986,0.5248812678637101
457,Immortals,226904017,83504017,143400000,2011,0.3680147143450528,0.6319852856549473
458,Percy Jackson & the Olympians: The Lightning Thief,226497209,88768303,137728906,2010,0.39191786685548075,0.6080821331445192
459,Hansel & Gretel: Witch Hunters,226349749,55703475,170646274,2013,0.2460947062945495,0.7539052937054505
460,Valerian and the City of a Thousand Planets,225874228,41189488,184684740,2017,0.18235585513545174,0.8176441448645483
461,Ford v Ferrari,225508210,117624357,107883853,2019,0.521596783549477,0.47840321645052303
462,Better Days,225320294,1921657,223398637,2019,0.008528557130322224,0.9914714428696778
463,The Social Network,224920315,96962694,127957621,2010,0.4310979824121267,0.5689020175878733
464,Chicken Run,224834564,106834564,118000000,2000,0.47516966297050306,0.524830337029497
465,Flightplan,223387299,89707299,133680000,2005,0.40157743704130644,0.5984225629586936
466,Dolittle,223343452,77047065,146296387,2020,0.34497122843789485,0.6550287715621051
467,Non-Stop,222809600,92168600,130641000,2014,0.4136652998793589,0.5863347001206412
468,Fahrenheit 9/11,222446882,119194771,103252111,2004,0.5358347571713772,0.4641652428286228
469,Geostorm,221600160,33700160,187900000,2017,0.15207642449355632,0.8479235755064437
470,Collateral,220926695,101005703,119920992,2004,0.4571910289066697,0.5428089710933303
471,Scary Movie 3,220673217,110003217,110670000,2003,0.4984892072335176,0.5015107927664824
472,Elf,220443451,173398518,47044933,2003,0.7865895639603283,0.2134104360396717
473,Inferno,220021259,34343574,185677685,2016,0.15609207108482184,0.8439079289151782
474,Green Lantern,219851172,116601172,103250000,2011,0.5303641137742036,0.46963588622579644
475,The Terminal,219100084,77872883,141227201,2004,0.3554215113856369,0.6445784886143631
476,Captain Phillips,218791811,107100855,111690956,2013,0.4895103455220269,0.5104896544779731
477,Jack Reacher,218340595,80070736,138269859,2012,0.3667239983476275,0.6332760016523725
478,Kingdom of Heaven,218122627,47398413,170724214,2005,0.2173016786561992,0.7826983213438008
479,The Emoji Movie,217776646,86089513,131687133,2017,0.39531104267259215,0.6046889573274078
480,Dracula Untold,217124280,56280355,160843925,2014,0.2592080213230874,0.7407919786769126
481,Central Intelligence,216972543,127440871,89531672,2016,0.5873594383783389,0.412640561621661
482,Million Dollar Baby,216763646,100492203,116271443,2004,0.4636026605679072,0.5363973394320928
483,The Help,216639112,169708112,46931000,2011,0.7833678343363962,0.21663216566360372
484,Valentine's Day,216485654,110485654,106000000,2010,0.5103601645585254,0.48963983544147455
485,Bad Teacher,216197492,100292856,115904636,2011,0.46389463204318765,0.5361053679568124
486,Ted 2,215863606,81476385,134387221,2015,0.37744382441197616,0.6225561755880239
487,Vertical Limit,215663859,69243859,146420000,2000,0.3210730778957266,0.6789269221042734
488,The Patriot,215294342,113330342,101964000,2000,0.5263972148418095,0.47360278515819054
489,The Sorcerer's Apprentice,215283742,63150991,152132751,2010,0.29333841196424393,0.7066615880357561
490,Just Go with It,214945591,103028109,111917482,2011,0.4793218066054679,0.5206781933945321
491,The Expendables 3,214657577,39322544,175335033,2014,0.18318730952599918,0.8168126904740008
492,Creed II,214215889,115715889,98500000,2018,0.5401835015142131,0.45981649848578693
493,Smallfoot,214040103,83240103,130800000,2018,0.3888995652370808,0.6111004347629192
494,The Bourne Identity,214034224,121661683,92372541,2002,0.5684216324208039,0.4315783675791961
495,The Aviator,213719942,102610330,111109612,2004,0.4801158424420684,0.5198841575579316
496,"Crouching Tiger, Hidden Dragon",213525736,128078872,85446864,2000,0.5998287344622477,0.40017126553775234
497,Into the Woods,212902372,128002372,84900000,2014,0.6012256735213829,0.39877432647861716
498,Miss Congeniality,212742720,106807667,105935053,2000,0.502050866887478,0.49794913311252204
499,Bridget Jones's Baby,211952420,24252420,187700000,2016,0.11442388815376583,0.8855761118462342
500,Battle Los Angeles,211819354,83552429,128266925,2011,0.3944513446113144,0.6055486553886856
501,Fury,211817906,85817906,126000000,2014,0.4051494400100433,0.5948505599899566
502,Due Date,211780824,100539043,111241781,2010,0.47473156965335067,0.5252684303466493
503,Master and Commander: The Far Side of the World,211622535,93927920,117694615,2003,0.44384649300226936,0.5561535069977307
504,Lemony Snicket's A Series of Unfortunate Events,211468235,118634549,92833686,2004,0.5610041101444858,0.43899588985551424
505,The Others,209947037,96522687,113424350,2001,0.4597477934399236,0.5402522065600764
506,Horrible Bosses,209838559,117538559,92300000,2011,0.5601380392628411,0.4398619607371589
507,Red Dragon,209196298,93149898,116046400,2002,0.44527507843374936,0.5547249215662506
508,Little Women,209101214,108101214,101000000,2019,0.516980327048699,0.483019672951301
509,Tomorrowland,209035668,93436322,115599346,2015,0.44698745861878464,0.5530125413812154
510,Me Before You,208314186,56245075,152069111,2016,0.2700011750519957,0.7299988249480043
511,Safe House,208076205,126373434,81702771,2012,0.6073420745058283,0.3926579254941717
512,S.W.A.T.,207725639,116934650,90790989,2003,0.562928344151104,0.43707165584889596
513,Traffic,207515725,124115725,83400000,2000,0.5981027461894756,0.4018972538105245
514,The Fast and the Furious,207283925,144533925,62750000,2001,0.697275126375574,0.302724873624426
515,Paranormal Activity 3,207039844,104028807,103011037,2011,0.5024579085366776,0.4975420914633224
516,London Has Fallen,205754447,62524260,143230187,2016,0.30387804935268303,0.696121950647317
517,Journey to the West,205637183,18058,205619125,2013,8.781485788005567e-05,0.99991218514212
518,White House Down,205366737,73103784,132262953,2013,0.35596701329485503,0.644032986705145
519,A Dog's Purpose,205035819,64508620,140527199,2017,0.3146212223533489,0.6853787776466511
520,Fun with Dick and Jane,204681899,110332737,94349162,2005,0.5390449157402043,0.46095508425979576
521,Eat Pray Love,204594016,80574010,124020006,2010,0.39382388388133505,0.606176116118665
522,King Arthur,203567857,51882244,151685613,2004,0.2548646174528428,0.7451353825471573
523,Yogi Bear,203510197,100246011,103264186,2010,0.492584708175581,0.507415291824419
524,Everest,203427584,43482270,159945314,2015,0.2137481512831613,0.7862518487168387
525,Vanilla Sky,203388341,100618344,102769997,2001,0.4947104809709815,0.5052895190290185
526,Arrival,203388186,100546139,102842047,2016,0.49435584719753584,0.5056441528024641
527,Need for Speed,203277636,43577636,159700000,2014,0.2143749644943726,0.7856250355056273
528,Garfield,203172417,75369589,127802828,2004,0.3709636874576336,0.6290363125423665
529,The Addams Family,203044905,100044905,103000000,2019,0.49272305059809307,0.5072769494019069
530,Birds of Prey: And the Fantabulous Emancipation of One Harley Quinn,201858461,84158461,117700000,2020,0.41691817416561006,0.5830818258343899
531,Straight Outta Compton,201634991,161197785,40437206,2015,0.7994534291917617,0.20054657080823834
532,21 Jump Street,201585328,138447667,63137661,2012,0.6867943633278708,0.31320563667212925
533,Cats & Dogs,200687492,93385515,107301977,2001,0.46532802851510047,0.5346719714848995
534,Percy Jackson: Sea of Monsters,199850315,68559554,131290761,2013,0.34305452057956476,0.6569454794204352
535,Two Weeks Notice,199043242,93354851,105688391,2002,0.469017938323171,0.530982061676829
536,RED,199006387,90380162,108626225,2010,0.45415709195303366,0.5458429080469663
537,The Pacifier,198636868,113086868,85550000,2005,0.5693145947105851,0.43068540528941485
538,50 First Dates,198520934,120908074,77612860,2004,0.609044454727379,0.390955545272621
539,Total Recall,198467168,58877969,139589199,2012,0.296663521696445,0.703336478303555
540,The Island,198326350,670883,197655467,2018,0.0033827224672868736,0.9966172775327131
541,The Impossible,198087212,19019882,179067330,2012,0.09601771769093302,0.903982282309067
542,Lost in Thailand,197757387,57387,197700000,2012,0.00029018890707733716,0.9997098110929227
543,Christopher Robin,197744377,99215042,98529335,2018,0.5017338217409844,0.4982661782590157
544,Jack the Giant Slayer,197687603,65187603,132500000,2013,0.3297505863329225,0.6702494136670776
545,Smurfs: The Lost Village,197183546,45020282,152163264,2017,0.22831662637814618,0.7716833736218538
546,Spy Kids 3-D: Game Over,197011982,111761982,85250000,2003,0.567285201973147,0.43271479802685303
547,The Other Woman,196710396,83911193,112799203,2014,0.4265722336301941,0.5734277663698059
548,Panic Room,196397415,96397334,100000081,2002,0.49082791644686363,0.5091720835531364
549,The Vow,196114570,125014030,71100540,2012,0.6374540657535032,0.36254593424649684
550,Anger Management,195745823,135645823,60100000,2003,0.6929691827957933,0.3070308172042067
551,The Shape of Water,195333312,63859435,131473877,2017,0.3269254708587545,0.6730745291412455
552,The BFG,195243411,55483770,139759641,2016,0.28417742609506036,0.7158225739049396
553,Rocketman,195179299,96368160,98811139,2019,0.4937417056713581,0.5062582943286419
554,The Intern,194564672,75764672,118800000,2015,0.38940610965591943,0.6105938903440805
555,Wallace & Gromit: The Curse of the Were-Rabbit,194111171,56110897,138000274,2005,0.2890657797329964,0.7109342202670036
556,Gnomeo & Juliet,193967670,99967670,94000000,2011,0.5153831563785862,0.48461684362141383
557,The Sum of All Fears,193921372,118907036,75014336,2002,0.6131713837090633,0.38682861629093673
558,Gangs of New York,193772504,77812000,115960504,2002,0.4015636810886234,0.5984363189113766
559,The Monkey King 2,193678298,709982,192968316,2016,0.003665779838689,0.996334220161311
560,Weathering with You,193145004,7798743,185346261,2019,0.040377658435317335,0.9596223415646826
561,Downton Abbey,192620184,96854135,95766049,2019,0.5028244340167384,0.4971755659832616
562,The Equalizer,192330738,101530738,90800000,2014,0.527896575741315,0.47210342425868507
563,The Lego Movie 2: The Second Part,192306508,105806508,86500000,2019,0.5501972299346208,0.44980277006537916
564,The Longest Yard,191466556,158119460,33347096,2005,0.8258333115888918,0.17416668841110822
565,The Equalizer 2,190400157,102084362,88315795,2018,0.5361569213411941,0.4638430786588059
566,Hollow Man,190213455,73209340,117004115,2000,0.3848799234523131,0.615120076547687
567,Cheaper by the Dozen,190212113,138614544,51597569,2003,0.7287366814541406,0.2712633185458594
568,The White Storm 2: Drug Lords,189396380,609461,188786919,2019,0.003217912612690908,0.9967820873873091
569,Breakup Buddies,189017596,777896,188239700,2014,0.004115468699538428,0.9958845313004616
570,The Secret Life of Walter Mitty,188133322,58236838,129896484,2013,0.30955089391341317,0.6904491060865868
571,12 Years a Slave,187733202,56671993,131061209,2013,0.30187517389704993,0.6981248261029501
572,Mr. Popper's Penguins,187361754,68224452,119137302,2011,0.3641322230576471,0.635867776942353
573,The Grudge,187281115,110359362,76921753,2004,0.5892711713084365,0.41072882869156346
574,Walk the Line,186797986,119519402,67278584,2005,0.6398323909123945,0.3601676090876055
575,Atlantis: The Lost Empire,186053725,84056472,101997253,2001,0.45178602040888993,0.5482139795911101
576,Hugo,185770160,73864507,111905653,2011,0.39761233451055866,0.6023876654894413
577,The Lion King 2011 3D Release,185542001,94242001,91300000,2011,0.5079281267425805,0.49207187325741947
578,Pitch Perfect 3,185400345,104897530,80502815,2017,0.5657892923554161,0.4342107076445839
579,Hop,183953723,108085305,75868418,2011,0.5875679123928359,0.4124320876071641
580,Bad Moms,183936074,113257297,70678777,2016,0.615742711785835,0.3842572882141651
581,Jupiter Ascending,183887723,47387723,136500000,2015,0.25769922117095334,0.7423007788290467
582,102 Dalmatians,183611771,66957026,116654745,2000,0.36466630453665194,0.6353336954633481
583,Storks,183388953,72679278,110709675,2016,0.3963121922616571,0.6036878077383429
584,Mirror Mirror,183018522,64935167,118083355,2012,0.3548010676209045,0.6451989323790955
585,The Haunted Mansion,182290266,75847266,106443000,2003,0.41607962764177436,0.5839203723582257
586,Abominable,181711947,60716390,120995557,2019,0.3341353774608997,0.6658646225391003
587,Scooby-Doo 2: Monsters Unleashed,181216833,84216833,97000000,2004,0.46472963689857666,0.5352703631014234
588,Road to Perdition,181001478,104454762,76546716,2002,0.5770934201984804,0.42290657980151963
589,Kill Bill: Vol. 1,180899045,70099045,110800000,2003,0.38750367642902706,0.612496323570973
590,Sweet Home Alabama,180622424,127223418,53399006,2002,0.7043611484252918,0.29563885157470815
591,Daddy's Home 2,180613180,104029443,76583737,2017,0.5759792447040687,0.42402075529593136
592,Hacksaw Ridge,180450918,67209615,113241303,2016,0.3724537161955585,0.6275462838044414
593,The Post,179769457,81903458,97865999,2017,0.4556027445752367,0.5443972554247632
594,The Dictator,179379533,59650222,119729311,2012,0.3325363880839181,0.6674636119160818
595,The League of Extraordinary Gentlemen,179265204,66465204,112800000,2003,0.37076466886457227,0.6292353311354277
596,Allegiant,179246868,66184051,113062817,2016,0.36923407219589466,0.6307659278041053
597,Moulin Rouge!,179213434,57386607,121826827,2001,0.320213756966456,0.6797862430335441
598,Daredevil,179179718,102543518,76636200,2003,0.5722942258453605,0.4277057741546395
599,The Scorpion King,178799308,91047077,87752231,2002,0.5092138108275005,0.4907861891724995
600,Along Came Polly,178311729,88097164,90214565,2004,0.4940626423963395,0.5059373576036605
601,Brokeback Mountain,178062759,83043761,95018998,2005,0.46637354978870116,0.5336264502112988
602,Baywatch,177856751,58060186,119796565,2017,0.32644353207599075,0.6735564679240093
603,War Horse,177584879,79884879,97700000,2011,0.44984054639021376,0.5501594536097862
604,Paranormal Activity 2,177512032,84752907,92759125,2010,0.4774488018930458,0.5225511981069543
605,How to Lose a Guy in 10 Days,177502387,105813373,71689014,2003,0.5961236622693981,0.4038763377306019
606,Alien vs. Predator,177427090,80282231,97144859,2004,0.4524801201439983,0.5475198798560017
607,Hero,177395557,53710019,123685538,2002,0.302769809505432,0.697230190494568
608,The 40-Year-Old Virgin,177378645,109449237,67929408,2005,0.6170372820245639,0.38296271797543613
609,Lee Daniels' The Butler,177313795,116632095,60681700,2013,0.6577722562421046,0.34222774375789544
610,The Descendants,177243185,82584160,94659025,2011,0.4659370119082435,0.5340629880917566
611,The A-Team,177238796,77222099,100016697,2010,0.4356952357090036,0.5643047642909964
612,The Hitman's Bodyguard,176586701,75468583,101118118,2017,0.4273741033306919,0.5726258966693081
613,Looper,176506819,66486205,110020614,2012,0.37667782682095696,0.623322173179043
614,Dr. Dolittle 2,176104344,112952899,63151445,2001,0.6413975739292382,0.35860242607076176
615,The Italian Job,176070171,106128601,69941570,2003,0.6027630938121824,0.3972369061878176
616,Cowboys & Aliens,174822325,100240551,74581774,2011,0.5733852984737504,0.4266147015262496
617,The Mule,174804407,103804407,71000000,2018,0.5938317504775494,0.40616824952245056
618,Identity Thief,173965010,134506920,39458090,2013,0.7731837568945618,0.22681624310543827
619,The Nutcracker and the Four Realms,173961069,54858851,119102218,2018,0.3153513100106323,0.6846486899893677
620,Big Momma's House,173959438,117559438,56400000,2000,0.6757864899517553,0.32421351004824467
621,In Time,173930596,37520095,136410501,2011,0.215718774401256,0.784281225598744
622,Amélie,173921954,33225499,140696455,2001,0.1910368313824257,0.8089631686175743
623,Operation Mekong,173839072,800012,173039060,2016,0.004602026407504062,0.9953979735924959
624,Creed,173567581,109767581,63800000,2015,0.6324198353608442,0.3675801646391557
625,Gemini Man,173469516,48546770,124922746,2019,0.27985764369112553,0.7201423563088745
626,The Girl on the Train,173185859,75395035,97790824,2016,0.435341750390833,0.564658249609167
627,Cold Mountain,173013509,95636509,77377000,2003,0.5527690268394013,0.4472309731605987
628,Black Hawk Down,172989651,108638745,64350906,2001,0.6280071921759065,0.3719928078240935
629,The Grand Budapest Hotel,172936941,59301324,113635617,2014,0.342907210322403,0.657092789677597
630,The Santa Clause 2,172855065,139236327,33618738,2002,0.8055090951485859,0.1944909048514141
631,Jackass 3D,171685792,117229692,54456100,2010,0.6828153374508708,0.3171846625491293
632,Spies in Disguise,171616764,66757013,104859751,2019,0.3889888810629246,0.6110111189370754
633,John Wick: Chapter 2,171539887,92029184,79510703,2017,0.5364885427492441,0.46351145725075593
634,Anchorman 2: The Legend Continues,171464676,125168368,46296308,2013,0.7299950690718361,0.2700049309281639
635,Mr. Deeds,171269535,126293452,44976083,2002,0.7373958947223159,0.2626041052776841
636,The Other Guys,170458922,119219978,51238944,2010,0.6994059131736149,0.30059408682638505
637,Olympus Has Fallen,170270201,98925640,71344561,2013,0.5809920903305916,0.4190079096694083
638,Starsky & Hutch,170268750,88237754,82030996,2004,0.5182263568623132,0.4817736431376867
639,Shall We Dance,170128460,57890460,112238000,2004,0.3402749898517861,0.6597250101482138
640,Stuart Little 2,169956806,64956806,105000000,2002,0.3821959680743824,0.6178040319256176
641,Zookeeper,169852759,80360843,89491916,2011,0.47312062207950356,0.5268793779204964
642,Dumb and Dumber To,169837010,86208010,83629000,2014,0.5075926030492411,0.49240739695075886
643,Ghost in the Shell,169801921,40563557,129238364,2017,0.23888750351652382,0.7611124964834762
644,The Emperor's New Groove,169327687,89302687,80025000,2000,0.5273956585729539,0.4726043414270461
645,Dodgeball,168423227,114326736,54096491,2004,0.6788062313994256,0.3211937686005743
646,Insidious: The Last Key,167885588,67745330,100140258,2018,0.40352081919026905,0.596479180809731
647,Fantastic Four,167882881,56117548,111765333,2015,0.3342660530110869,0.6657339469889131
648,Unstoppable,167805466,81562942,86242524,2010,0.48605652690717477,0.5139434730928253
649,Magic Mike,167739368,113721571,54017797,2012,0.6779658964733908,0.3220341035266092
650,Alexander,167298192,34297191,133001001,2004,0.20500634579481888,0.7949936542051811
651,Nutty Professor II: The Klumps,166339890,123309890,43030000,2000,0.7413128023590734,0.2586871976409267
652,Bridge of Spies,165478348,72313754,93164594,2015,0.4369982833041094,0.5630017166958906
653,The Princess Diaries,165335153,108248956,57086197,2001,0.6547243827814403,0.3452756172185597
654,The Muppets,165184237,88631237,76553000,2011,0.5365598958452676,0.4634401041547324
655,The Huntsman: Winter's War,164989338,48390190,116599148,2016,0.2932928308373478,0.7067071691626522
656,Bringing Down the House,164729679,132716677,32013002,2003,0.8056634226792854,0.19433657732071463
657,Daddy Day Care,164433867,104297061,60136806,2003,0.6342796827857853,0.3657203172142148
658,The Ring Two,163995949,76231249,87764700,2005,0.46483617104468844,0.5351638289553116
659,The Island,162949164,35818913,127130251,2005,0.21981648828833514,0.7801835117116649
660,The Interpreter,162944923,72708161,90236762,2005,0.4462131109172392,0.5537868890827609
661,The Magnificent Seven,162360636,93432655,68927981,2016,0.5754637164638847,0.4245362835361152
662,Memoirs of a Geisha,162242962,57490508,104752454,2005,0.35434823977141144,0.6456517602285885
663,Jack Reacher: Never Go Back,162146076,58697076,103449000,2016,0.36200121179620776,0.6379987882037922
664,Insidious: Chapter 2,161919318,83586447,78332871,2013,0.5162228203060983,0.4837771796939016
665,Limitless,161849455,79249455,82600000,2011,0.489649192825518,0.510350807174482
666,Scream 3,161834276,89143175,72691101,2000,0.5508300046400554,0.4491699953599446
667,Flight,161772375,93772375,68000000,2012,0.5796562917494411,0.42034370825055883
668,Into the Storm,161502194,47602194,113900000,2014,0.29474642307336085,0.7052535769266391
669,Unbroken,161459297,115637895,45821402,2014,0.7162046233856698,0.28379537661433024
670,Freaky Friday,160846332,110230332,50616000,2003,0.6853145522771387,0.31468544772286133
671,The Predator,160542134,51024708,109517426,2018,0.3178275181018835,0.6821724818981165
672,Johnny English,160466000,28082366,132383634,2003,0.1750050851893859,0.824994914810614
673,"Three Billboards Outside Ebbing, Missouri",160192031,54513740,105678291,2017,0.3403024461310438,0.6596975538689562
674,Underworld Awakening,160112671,62321039,97791632,2012,0.3892323987275186,0.6107676012724814
675,Lara Croft Tomb Raider: The Cradle of Life,160099222,65660196,94439026,2003,0.41012189303455826,0.5898781069654417
676,Johnny English Reborn,160078586,8305970,151772616,2011,0.051886827636021225,0.9481131723639787
677,Step Up 3D,159291809,42400223,116891586,2010,0.26617955603731014,0.7338204439626899
678,Happy Feet Two,159196259,64006466,95189793,2011,0.4020601137367179,0.5979398862632821
679,Johnny English Strikes Again,158970776,4412170,154558606,2018,0.02775459811556811,0.9722454018844319
680,Focus,158762963,53862963,104900000,2015,0.3392665517334795,0.6607334482665205
681,Sin City,158733820,74103820,84630000,2005,0.4668432977924931,0.5331567022075069
682,Goosebumps,158260952,80080379,78180573,2015,0.5060021312142745,0.4939978687857255
683,Final Destination 5,157887643,42587643,115300000,2011,0.26973385751283907,0.7302661424871609
684,Don't Breathe,157830487,89217875,68612612,2016,0.565276561555563,0.4347234384444369
685,Hustlers,157563598,104963598,52600000,2019,0.6661665469203109,0.33383345307968915
686,The Book of Eli,157107755,94835059,62272696,2010,0.6036306673722122,0.39636933262778784
687,Ip Man 3,156954938,2679437,154275501,2015,0.01707137751855886,0.9829286224814411
688,The Climbers,156759167,487157,156272010,2019,0.0031076779069641267,0.9968923220930359
689,Mystic River,156595191,90135191,66460000,2003,0.5755936081076717,0.4244063918923283
690,This Means War,156491279,54760791,101730488,2012,0.3499287075288074,0.6500712924711926
691,The Hateful Eight,155760117,54117416,101642701,2015,0.3474407765114866,0.6525592234885135
692,Escape Room,155712077,57005601,98706476,2019,0.36609620845273294,0.6339037915472671
693,The Monuments Men,155641650,78031620,77610030,2014,0.5013543611237737,0.49864563887622626
694,Monster-in-Law,155457327,82931301,72526026,2005,0.5334666599535705,0.4665333400464296
695,The Accountant,155160045,86260045,68900000,2016,0.5559423819450426,0.44405761805495736
696,Blade II,155010032,82348319,72661713,2002,0.5312450938659248,0.4687549061340752
697,Maid in Manhattan,154906693,94011225,60895468,2002,0.6068893679113013,0.39311063208869873
698,Lone Survivor,154802912,125095601,29707311,2013,0.8080959161801814,0.19190408381981858
699,The Phantom of the Opera,154648887,51268815,103380072,2004,0.331517516837997,0.668482483162003
700,Ride Along,154468902,134938200,19530702,2014,0.8735622397315933,0.12643776026840664
701,Kill Bill: Vol. 2,154116796,66208183,87908613,2004,0.4295974528305143,0.5704025471694857
702,The Town,154026136,92186262,61839874,2010,0.598510515124524,0.4014894848754759
703,Midnight in Paris,153959590,56817045,97142545,2011,0.36903868735945583,0.6309613126405442
704,Tower Heist,152930623,78046570,74884053,2011,0.5103397113604906,0.48966028863950944
705,Duckweed,152894264,471575,152422689,2017,0.0030843210704098096,0.9969156789295902
706,Chocolat,152699946,71509363,81190583,2000,0.4682998578139641,0.5317001421860359
707,Yesterday,152397918,73286650,79111268,2019,0.48089009982406716,0.5191099001759328
708,Date Night,152263880,98711404,53552476,2010,0.6482916631311378,0.35170833686886216
709,Jackass Presents: Bad Grandpa,151826547,102003019,49823528,2013,0.6718391547164674,0.3281608452835327
710,47 Ronin,151783839,38362475,113421364,2013,0.25274413437388416,0.7472558656261158
711,Red Sparrow,151572634,46874505,104698129,2018,0.30925440670246584,0.6907455932975342
712,Darkest Hour,150847207,56468410,94378797,2017,0.37434176689794463,0.6256582331020554
713,Gods of Egypt,150680864,31153464,119527400,2015,0.20675129656808977,0.7932487034319102
714,I Am Number Four,149878437,55100437,94778000,2011,0.36763418476268206,0.6323658152373179
715,Jack and Jill,149673788,74158157,75515631,2011,0.49546522467915355,0.5045347753208465
716,Friends with Benefits,149542245,55802754,93739491,2011,0.37315712359407205,0.626842876405928
717,"Me, Myself & Irene",149270999,90570999,58700000,2000,0.606755495754403,0.393244504245597
718,No Strings Attached,149228077,70662220,78565857,2011,0.473518264260686,0.526481735739314
719,Lights Out,148868835,67268835,81600000,2016,0.4518664702387172,0.5481335297612828
720,The Secret World of Arrietty,148800274,19202743,129597531,2010,0.12905045457107156,0.8709495454289284
721,King Arthur: Legend of the Sword,148675066,39175066,109500000,2017,0.2634945257061463,0.7365054742938537
722,Seabiscuit,148336445,120277854,28058591,2003,0.8108449275564074,0.18915507244359267
723,RED 2,148075565,53262560,94813005,2013,0.35969850933879605,0.640301490661204
724,Spy Kids,147934180,112719001,35215179,2001,0.7619537351002993,0.23804626489970065
725,The Mexican,147845033,66845033,81000000,2001,0.4521290410885836,0.5478709589114164
726,The Angry Birds Movie 2,147792047,41667116,106124931,2019,0.2819307049722371,0.7180692950277628
727,Saw II,147748505,87039965,60708540,2005,0.5891089388687892,0.41089106113121077
728,Arthur Christmas,147419472,46462469,100957003,2011,0.31517185870805453,0.6848281412919455
729,Source Code,147332697,54712227,92620470,2011,0.3713515608826464,0.6286484391173536
730,Swordfish,147080413,69772969,77307444,2001,0.4743865452703073,0.5256134547296927
731,Planes: Fire & Rescue,146965787,59165787,87800000,2014,0.402582044486313,0.597417955513687
732,The Last Witch Hunter,146936910,27367660,119569250,2015,0.18625449521158435,0.8137455047884157
733,Angel Has Fallen,146661977,69030436,77631541,2019,0.470677113537069,0.529322886462931
734,Mama,146428180,71628180,74800000,2013,0.4891693661698179,0.5108306338301821
735,The Foreigner,145374099,34393507,110980592,2017,0.23658620921186244,0.7634137907881375
736,Home on the Range,145358062,50030461,95327601,2004,0.344187727268956,0.655812272731044
737,The Exorcism of Emily Rose,145166804,75072454,70094350,2005,0.5171461514024929,0.4828538485975072
738,"Crazy, Stupid, Love",145051197,84351197,60700000,2011,0.5815270659227997,0.4184729340772003
739,Herbie Fully Loaded,144146816,66023816,78123000,2005,0.4580317334237893,0.5419682665762108
740,The Beach,144056873,39785027,104271846,2000,0.2761758336931276,0.7238241663068724
741,Pete's Dragon,143695338,76233151,67462187,2016,0.5305193060612725,0.4694806939387275
742,Spy Game,143049560,62362560,80687000,2001,0.435950729243767,0.564049270756233
743,More Than Blue,142958164,722669,142235495,2018,0.005055108290282743,0.9949448917097172
744,Paranormal Activity 4,142802657,53885000,88917657,2012,0.3773389174404507,0.6226610825595493
745,The Legend of Zorro,142400065,46464023,95936042,2005,0.32629214740878104,0.673707852591219
746,Power Rangers,142337240,85364450,56972790,2017,0.5997337731151735,0.4002662268848265
747,New Year's Eve,142044638,54544638,87500000,2011,0.3839964589159641,0.6160035410840359
748,Legally Blonde,141774679,96520674,45254005,2001,0.6808033330126602,0.31919666698733984
749,The Taking of Tiger Mountain,141654055,228984,141425071,2014,0.0016165015537324364,0.9983834984462676
750,Gothika,141591324,59694580,81896744,2003,0.42159772444814486,0.5784022755518552
751,Mona Lisa Smile,141337989,63860942,77477047,2003,0.4518314039405216,0.5481685960594784
752,Scary Movie 2,141220678,71308997,69911681,2001,0.5049472783298774,0.49505272167012254
753,Shallow Hal,141069860,70839203,70230657,2001,0.5021568958812321,0.4978431041187678
754,Trainwreck,140795793,110212700,30583093,2015,0.7827840424180856,0.2172159575819144
755,Sausage Party,140705322,97685686,43019636,2016,0.6942572221966131,0.3057427778033869
756,Girls Trip,140552359,115171585,25380774,2017,0.8194212165446473,0.18057878345535275
757,Step Up Revolution,140470746,35074677,105396069,2012,0.24969381881121355,0.7503061811887864
758,Lion,140312928,51738905,88574023,2016,0.3687394008341127,0.6312605991658873
759,The SpongeBob SquarePants Movie,140192993,85417988,54775005,2004,0.6092885683666087,0.3907114316333913
760,Legend of the Guardians: The Owls of Ga'Hoole,140073390,55675313,84398077,2010,0.3974724464082721,0.6025275535917278
761,The Wolfman,139789765,61979680,77810085,2010,0.4433778109577622,0.5566221890422378
762,Mr. Six,139191345,1415450,137775895,2015,0.010169094924688026,0.989830905075312
763,The Admiral: Roaring Currents,138342258,2589811,135752447,2014,0.018720317547513212,0.9812796824524868
764,America's Sweethearts,138307673,93607673,44700000,2001,0.676807518842429,0.32319248115757104
765,Let's Be Cops,138224951,82390774,55834177,2014,0.5960629640592168,0.40393703594078323
766,Escape Plan,137328301,25135965,112192336,2013,0.18303557836923942,0.8169644216307606
767,The First Purge,137056262,69488745,67567517,2018,0.5070089026650968,0.49299109733490326
768,Annie,136853506,85911262,50942244,2014,0.6277607677804031,0.3722392322195969
769,The Best Exotic Marigold Hotel,136836156,46412041,90424115,2012,0.3391796609662142,0.6608203390337858
770,How Long Will I Love U,136796719,746933,136049786,2018,0.005460167505918033,0.994539832494082
771,Remember the Titans,136706683,115654751,21051932,2000,0.8460065628247304,0.15399343717526962
772,Contagion,136515867,75658097,60857770,2011,0.5542073508568788,0.4457926491431212
773,The Wind Rises,136454220,5209580,131244640,2012,0.03817822563494189,0.9618217743650581
774,The Bounty Hunter,136333522,67061228,69272294,2010,0.49189096721201114,0.5081090327879888
775,Saw: The Final Chapter,136150434,45710178,90440256,2010,0.3357328849939619,0.6642671150060381
776,Unknown,135710029,63686397,72023632,2011,0.4692829076029451,0.5307170923970549
777,The Jungle Book 2,135703599,47901582,87802017,2003,0.35298682093169836,0.6470131790683017
778,Jack Ryan: Shadow Recruit,135503748,50577412,84926336,2014,0.3732547087922616,0.6267452912077384
779,American Made,134866593,51342000,83524593,2017,0.3806873063072039,0.6193126936927961
780,Wall Street: Money Never Sleeps,134748021,52474616,82273405,2010,0.38942773044510987,0.6105722695548902
781,The Princess Diaries 2: Royal Engagement,134734481,95170481,39564000,2004,0.7063557917293644,0.29364420827063564
782,Last Vegas,134402450,63914167,70488283,2012,0.4755431690419334,0.5244568309580666
783,The Cat in the Hat,133960541,101149285,32811256,2003,0.7550677553623795,0.24493224463762056
784,Pokémon the Movie 2000,133949270,43758684,90190586,2000,0.32668101886632156,0.6733189811336785
785,Point Break,133718711,28782481,104936230,2015,0.21524647362178057,0.7847535263782194
786,The Big Short,133440870,70259870,63181000,2015,0.5265243699325401,0.47347563006745985
787,The Artist,133432856,44671682,88761174,2011,0.33478772274798646,0.6652122772520136
788,Zero Dark Thirty,132820716,95720716,37100000,2012,0.7206761029657452,0.2793238970342548
789,A Wrinkle in Time,132675864,100478608,32197256,2018,0.7573239394921144,0.2426760605078856
790,Ghost Rider: Spirit of Vengeance,132563930,51774002,80789928,2012,0.39055874399619867,0.6094412560038014
791,The Three Musketeers,132274484,20374484,111900000,2011,0.1540318539439549,0.8459681460560451
792,Blade: Trinity,131977904,52411906,79565998,2004,0.39712637048698696,0.602873629513013
793,2 Guns,131940411,75612460,56327951,2013,0.5730803733815867,0.4269196266184134
794,Save the Last Dance,131706809,91057006,40649803,2001,0.6913614162499374,0.3086385837500626
795,The House with a Clock in Its Walls,131457147,68549695,62907452,2018,0.521460388912898,0.478539611087102
796,Bewitched,131426169,63313159,68113010,2005,0.4817393634900824,0.5182606365099176
797,School of Rock,131095614,81261177,49834437,2003,0.6198619047621227,0.3801380952378773
798,Munich,130982129,47403685,83578444,2005,0.36190956248695577,0.6380904375130443
799,Man on Fire,130834852,77911774,52923078,2004,0.595497092777695,0.404502907222305
800,A Bad Moms Christmas,130560428,72110659,58449769,2017,0.5523163496369665,0.4476836503630334
801,About a Boy,130549455,41385278,89164177,2002,0.317008431785487,0.682991568214513
802,Cloud Atlas,130482868,27108272,103374596,2012,0.2077534960375028,0.7922465039624972
803,Cheaper by the Dozen 2,130154568,82571173,47583395,2005,0.6344085672044949,0.3655914327955051
804,Mean Girls,130125829,86058055,44067774,2004,0.6613449125461479,0.3386550874538521
805,Resident Evil: Apocalypse,129342769,51201453,78141316,2004,0.3958586428592695,0.6041413571407305
806,The Woman in Black,128955898,54333290,74622608,2012,0.4213323379749564,0.5786676620250436
807,Space Cowboys,128884132,90464773,38419359,2000,0.70190776472002,0.29809223527998
808,Pan,128388320,35088320,93300000,2015,0.2732983810365304,0.7267016189634695
809,Space Station 3D,128363881,93383953,34979928,2002,0.7274939980974866,0.2725060019025134
810,Blended,127994610,46294610,81700000,2014,0.36169187124364066,0.6383081287563593
811,The Adjustment Bureau,127869379,62495645,65373734,2010,0.4887459803804944,0.5112540196195057
812,U-571,127666415,77122415,50544000,2000,0.6040932143351875,0.39590678566481247
813,Ad Astra,127461872,50188370,77273502,2019,0.393752023350167,0.606247976649833
814,March of the Penguins,127392693,77437223,49955470,2005,0.60786235989218,0.39213764010782
815,Predators,127233108,52000688,75232420,2010,0.40870406152461514,0.5912959384753849
816,Chronicle,126636097,64575175,62060922,2012,0.5099270786906833,0.49007292130931673
817,Walking with Dinosaurs 3D,126546518,36076121,90470397,2012,0.2850818937586256,0.7149181062413744
818,The Invisible Man,126278339,64914050,61364289,2020,0.5140553044493245,0.48594469555067554
819,Sex Tape,126069509,38543473,87526036,2014,0.30573191968249835,0.6942680803175016
820,This Is the End,126041322,101470202,24571120,2013,0.8050550437736602,0.1949449562263398
821,The Upside,125852517,108252517,17600000,2019,0.860153770305603,0.13984622969439697
822,Detective Chinatown,125842935,474252,125368683,2015,0.003768602504383738,0.9962313974956163
823,Wolf Totem,125837070,210591,125626479,2015,0.0016735211651065938,0.9983264788348934
824,Mechanic: Resurrection,125729635,21218403,104511232,2016,0.1687621458536804,0.8312378541463196
825,Midway,125647353,56846802,68800551,2019,0.45243135364737846,0.5475686463526215
826,Ender's Game,125544024,61737191,63806833,2013,0.49175730578780874,0.5082426942121913
827,Happy Death Day,125479266,55683845,69795421,2017,0.44376929173302626,0.5562307082669737
828,Captain Underpants: The First Epic Movie,125427681,73921000,51506681,2017,0.5893515642691345,0.4106484357308655
829,Legally Blonde 2,124914842,90186328,34728514,2003,0.7219824846754399,0.2780175153245601
830,The Family Man,124745083,75793305,48951778,2000,0.6075855110056723,0.39241448899432774
831,Ride Along 2,124605297,91221830,33383467,2015,0.7320862932496361,0.2679137067503639
832,Ray,123971376,75331600,48639776,2004,0.6076531731002163,0.39234682689978373
833,The Time Machine,123729176,56832494,66896682,2002,0.4593297703687932,0.5406702296312068
834,The Theory of Everything,123726688,35893537,87833151,2014,0.2901034334645731,0.7098965665354269
835,Nanny McPhee,123276807,47144110,76132697,2005,0.3824248141014879,0.6175751858985121
836,Big Fish,123218424,66809693,56408731,2003,0.5422053848051165,0.4577946151948835
837,Hide and Seek,123204920,51100486,72104434,2005,0.41476010860605245,0.5852398913939476
838,The Curse of la Llorona,123133739,54733739,68400000,2019,0.4445064321485438,0.5554935678514562
839,The Lego Ninjago Movie,123081555,59281555,63800000,2017,0.4816445079849698,0.5183554920150302
840,The Pirates! Band of Misfits,123054041,31051126,92002915,2012,0.25233731251458863,0.7476626874854114
841,Looking Up,122994583,84267,122910316,2019,0.0006851277344466463,0.9993148722655534
842,Zombieland: Double Tap,122810399,73123082,49687317,2019,0.5954144160056023,0.40458558399439776
843,Dragon Blade,122593849,74068,122519781,2015,0.0006041738684621934,0.9993958261315378
844,Spirit: Stallion of the Cimarron,122563539,73280117,49283422,2002,0.5978949171825073,0.40210508281749274
845,Prisoners,122126687,61002302,61124385,2013,0.4995001788593512,0.5004998211406488
846,Secret Superstar,122026260,0,122026260,2017,0.0,1.0
847,Peter Pan,121975011,48462608,73512403,2003,0.3973158731668407,0.6026841268331593
848,Deepwater Horizon,121790373,61433527,60356846,2016,0.5044202221139433,0.4955797778860567
849,Pride & Prejudice,121616555,38405088,83211467,2005,0.31578832339067653,0.6842116766093235
850,Last Christmas,121550750,35150750,86400000,2019,0.2891857927655732,0.7108142072344268
851,The Nut Job,120885527,64251541,56633986,2014,0.531507307735855,0.4684926922641451
852,Intolerable Cruelty,120801243,35327628,85473615,2003,0.2924442424818427,0.7075557575181574
853,Instant Family,120556201,67363237,53192964,2018,0.5587704028596588,0.4412295971403412
854,We Bought a Zoo,120081841,75624550,44457291,2011,0.629775071486454,0.37022492851354605
855,The Pianist,120072577,32572577,87500000,2002,0.27127407284679167,0.7287259271532084
856,The Commuter,119942387,36343858,83598529,2017,0.3030109614210029,0.6969890385789971
857,Extreme Job,119932733,1565885,118366848,2019,0.013056360518358236,0.9869436394816418
858,Parental Guidance,119772232,77267296,42504936,2012,0.6451186114658028,0.35488138853419715
859,Road Trip,119754278,68540777,51213501,2000,0.5723451232364325,0.4276548767635675
860,Spy Kids 2: Island of Lost Dreams,119723358,85846429,33876929,2002,0.7170399363505991,0.2829600636494008
861,Dora and the Lost City of Gold,119682635,60477943,59204692,2019,0.505319280445321,0.4946807195546789
862,Wonder Park,119559110,45216793,74342317,2019,0.37819613244026323,0.6218038675597368
863,Allied,119520023,40098064,79421959,2016,0.33549243878575896,0.664507561214241
864,Sahara,119240351,68671925,50568426,2005,0.5759117985152526,0.4240882014847474
865,Unfaithful,119137784,52775765,66362019,2002,0.442980918631154,0.557019081368846
866,I Belonged to You,119107580,744541,118363039,2016,0.006250995948368693,0.9937490040516314
867,The Shallows,119100758,55124043,63976715,2016,0.46283536667331704,0.537164633326683
868,Lost in Translation,118685453,44585453,74100000,2003,0.3756606380396088,0.6243393619603912
869,The Purge: Election Year,118587880,79213375,39374505,2016,0.6679719293405025,0.3320280706594974
870,Jurassic Park 2013 Re-release,118192315,45385935,72806380,2013,0.38400072796611184,0.6159992720338882
871,A Cool Fish,118153135,551876,117601259,2018,0.004670853634141828,0.9953291463658581
872,Why Him?,118102725,60323786,57778939,2016,0.5107738707976467,0.4892261292023533
873,Corpse Bride,118090836,53359111,64731725,2005,0.4518480248543587,0.5481519751456413
874,P Storm,117991727,326711,117665016,2019,0.0027689314183866466,0.9972310685816134
875,Saving Mr. Banks,117867984,83301580,34566404,2013,0.7067362753909493,0.29326372460905076
876,Pompeii,117831631,23219748,94611883,2014,0.19705869979852864,0.8029413002014714
877,Magic Mike XXL,117813057,66013057,51800000,2015,0.5603203811271954,0.43967961887280455
878,Game Night,117679066,69179066,48500000,2018,0.5878621266419637,0.41213787335803637
879,The Forgotten,117592831,67133509,50459322,2004,0.5708979742140914,0.42910202578590867
880,A Knight's Tale,117487473,56569702,60917771,2001,0.4814956059187689,0.5185043940812311
881,Paycheck,117248958,53790451,63458507,2003,0.4587712498050516,0.5412287501949484
882,Water for Elephants,117094902,58709717,58385185,2011,0.5013857648559286,0.49861423514407144
883,Warm Bodies,116980662,66380662,50600000,2013,0.5674498747493838,0.4325501252506162
884,Finding Neverland,116650613,51680613,64970000,2004,0.4430376461030685,0.5569623538969315
885,Freddy vs. Jason,116632628,82622655,34009973,2003,0.7084008687517527,0.29159913124824727
886,Abraham Lincoln: Vampire Hunter,116471580,37519139,78952441,2012,0.32213127872052566,0.6778687212794744
887,Personal Tailor,116126458,375892,115750566,2013,0.0032369195312923434,0.9967630804687077
888,The Chronicles of Riddick,115900534,57761012,58139522,2004,0.49836709121633554,0.5016329087836644
889,The Iron Lady,115890699,30017992,85872707,2011,0.25901985456140875,0.7409801454385913
890,The Notebook,115882795,81001787,34881008,2004,0.6989975259053771,0.30100247409462294
891,A Nightmare on Elm Street,115694863,63075011,52619852,2010,0.5451841971583474,0.4548158028416525
892,Dragon Ball Super: Broly,115560610,30712119,84848491,2018,0.2657663281632037,0.7342336718367963
893,Closer,115505027,33987757,81517270,2004,0.2942534873395597,0.7057465126604403
894,Pitch Perfect,115350426,65001093,50349333,2012,0.5635097784554346,0.4364902215445654
895,The Monkey King 3,115084576,187074,114897502,2018,0.0016255349457081026,0.998374465054292
896,Snow Dogs,115035090,81172560,33862530,2002,0.7056330377104933,0.2943669622895066
897,The Gentlemen,114996853,36296853,78700000,2020,0.31563344607351995,0.68436655392648
898,Dear John,114984666,80014842,34969824,2010,0.6958740220195969,0.3041259779804031
899,So Young,114926694,11186,114915508,2013,9.733160861653256e-05,0.9999026683913834
900,Finding Mr Right 2,114679097,0,114679097,2016,0.0,1.0
901,We Were Soldiers,114660784,78122718,36538066,2002,0.6813377274657393,0.3186622725342607
902,Office Christmas Party,114501299,54767494,59733805,2016,0.47831329843690246,0.5216867015630976
903,Hope Springs,114281051,63536011,50745040,2012,0.5559627816163504,0.4440372183836496
904,The Score,114252154,71107711,43144443,2001,0.6223752332931947,0.3776247667068054
905,Seventh Son,114178613,17223265,96955348,2014,0.15084493100297164,0.8491550689970284
906,Coyote Ugly,113916474,60786269,53130205,2000,0.5336038490798092,0.4663961509201909
907,Insomnia,113714830,67355513,46359317,2002,0.5923195154053346,0.40768048459466544
908,The Dark Tower,113231078,50701325,62529753,2017,0.44776863291895885,0.5522313670810411
909,Pet Sematary,113118226,54724696,58393530,2019,0.4837831880425706,0.5162168119574294
910,White Chicks,113100873,70831760,42269113,2004,0.6262706743209666,0.37372932567903344
911,Insidious: Chapter 3,112983889,52218558,60765331,2015,0.46217702773534375,0.5378229722646563
912,Final Destination,112880294,53331147,59549147,2000,0.47245754870199047,0.5275424512980096
913,Cats & Dogs: The Revenge of Kitty Galore,112483764,43585753,68898011,2010,0.3874848373672844,0.6125151626327155
914,Tooth Fairy,112462508,60022256,52440252,2010,0.5337090295016362,0.46629097049836377
915,How to Be Single,112343513,46843513,65500000,2016,0.4169667811616324,0.5830332188383677
916,The Exorcist 2000 Director's Cut,112053066,39671011,72382055,2000,0.3540377110252387,0.6459622889747613
917,The Purge: Anarchy,111928365,71962800,39965565,2014,0.6429362208587609,0.35706377914123916
918,Get Hard,111711453,90411453,21300000,2015,0.809330203591569,0.19066979640843093
919,The Dukes of Hazzard,111069515,80270227,30799288,2005,0.7227025975579348,0.27729740244206524
920,Good Boys,111011582,83140306,27871276,2019,0.748933620277567,0.25106637972243295
921,Mission to Mars,110983407,60883407,50100000,2000,0.5485811676334643,0.4514188323665357
922,Free Birds,110387072,55750480,54636592,2013,0.5050453734292364,0.49495462657076367
923,The Kid,110317580,69691949,40625631,2000,0.6317392839835682,0.36826071601643184
924,10 Cloverfield Lane,110216998,72082998,38134000,2016,0.6540098107190326,0.34599018928096736
925,Moneyball,110206216,75605492,34600724,2011,0.6860365480654921,0.3139634519345079
926,Buddies in India,110155128,293194,109861934,2017,0.002661646401064506,0.9973383535989355
927,Hoodwinked!,110013167,51386611,58626556,2005,0.46709509780770153,0.5329049021922985
928,The 5th Wave,109906372,34916787,74989585,2015,0.3176957474312772,0.6823042525687227
929,Peter Pan 2: Return to Never Land,109862682,48430258,61432424,2002,0.4408253750805028,0.5591746249194972
930,Sideways,109706931,71503593,38203338,2004,0.6517691484779572,0.34823085152204286
931,Treasure Planet,109578115,38176783,71401332,2002,0.3483978803614207,0.6516021196385793
932,Along With the Gods: The Two Worlds,109383972,1908823,107475149,2017,0.017450664526974757,0.9825493354730253
933,Billy Elliot,109280263,21995263,87285000,2000,0.20127388419627065,0.7987261158037293
934,The Hours,108846072,41675994,67170078,2002,0.382889278723811,0.617110721276189
935,Sanctum,108609310,23209310,85400000,2010,0.2136954005140075,0.7863045994859925
936,Cinderella Man,108539911,61649911,46890000,2005,0.5679930122662437,0.4320069877337563
937,The Boxtrolls,108255770,50837305,57418465,2014,0.4696036525351027,0.5303963474648973
938,Hidalgo,108040622,67303450,40737172,2004,0.6229457842254925,0.3770542157745075
939,Neighbors 2: Sorority Rising,108007109,55455765,52551344,2016,0.5134455084803723,0.48655449151962765
940,Horrible Bosses 2,107645357,54445357,53200000,2014,0.5057845365313806,0.49421546346861944
941,The Call of the Wild,107604626,62342368,45262258,2020,0.579365128781731,0.420634871218269
942,Paul Blart: Mall Cop 2,107588225,71038190,36550035,2015,0.6602784830774929,0.33972151692250707
943,The Amityville Horror,107516369,65233369,42283000,2005,0.6067296506265013,0.39327034937349864
944,Vacation,107228221,58884188,48344033,2015,0.5491482321617552,0.45085176783824477
945,Shaft,107196498,70334258,36862240,2000,0.656124587204332,0.343875412795668
946,ParaNorman,107139399,56003051,51136348,2012,0.5227120137196215,0.4772879862803785
947,The Texas Chainsaw Massacre,107071655,80571655,26500000,2003,0.7525021911728179,0.24749780882718214
948,The Man from U.N.C.L.E.,107045109,45445109,61600000,2015,0.42454166682197503,0.575458333178025
949,The Breakup Guru,106980263,208959,106771304,2014,0.00195324814260365,0.9980467518573963
950,Hereafter,106956330,32746941,74209389,2010,0.30617113545313307,0.693828864546867
951,The Whole Nine Yards,106371651,57262492,49109159,2000,0.5383247459419428,0.46167525405805726
952,Shaun the Sheep Movie,106209378,19375982,86833396,2015,0.18243193176406702,0.817568068235933
953,About Schmidt,105834556,65016287,40818269,2002,0.6143200241705554,0.3856799758294446
954,Life as We Know It,105734416,53374681,52359735,2010,0.50479950634049,0.4952004936595101
955,First Man,105697415,44936545,60760870,2018,0.4251432733714443,0.5748567266285557
956,The Brothers Grimm,105316267,37916267,67400000,2005,0.36002289181024616,0.6399771081897538
957,Gangster Squad,105200903,46000903,59200000,2013,0.4372671877160598,0.5627328122839402
958,Along Came a Spider,105178561,74078174,31100387,2001,0.7043086851131192,0.2956913148868808
959,Sisters,105011053,87044645,17966408,2015,0.8289093625220576,0.17109063747794245
960,The Campaign,104907746,86907746,18000000,2012,0.8284206773444546,0.17157932265554537
961,Training Day,104876233,76631907,28244326,2001,0.7306889731632523,0.2693110268367477
962,Let the Bullets Fly,104723314,63012,104660302,2010,0.0006016998277957476,0.9993983001722042
963,Scary Stories to Tell in the Dark,104545505,68947075,35598430,2019,0.6594934425922951,0.3405065574077049
964,The Hitchhiker's Guide to the Galaxy,104478416,51085416,53393000,2005,0.48895664727535687,0.5110433527246432
965,Book Club,104438188,68566296,35871892,2018,0.6565251400187065,0.34347485998129346
966,The Tuxedo,104391623,50547998,53843625,2002,0.4842150792118636,0.5157849207881364
967,The Cell,104155843,61334059,42821784,2000,0.5888681540410555,0.4111318459589444
968,Ouija,103590271,50856010,52734261,2014,0.49093423068658637,0.5090657693134136
969,The Stepford Wives,103370127,59484742,43885385,2004,0.5754538929801257,0.42454610701987433
970,Rugrats in Paris: The Movie,103291131,76507756,26783375,2000,0.7407001478181123,0.2592998521818877
971,Birdman or (The Unexpected Virtue of Ignorance),103215094,42340598,60874496,2014,0.41021711417518064,0.5897828858248194
972,Cold War II,103197501,560824,102636677,2016,0.00543447268165922,0.9945655273183408
973,Guess Who,103121466,68915888,34205578,2005,0.6682981795468268,0.33170182045317315
974,Night School,103105878,77339130,25766748,2018,0.75009428657404,0.24990571342596005
975,Saw,103096345,55185045,47911300,2004,0.5352764445723076,0.4647235554276924
976,Transcendence,103039258,23022309,80016949,2014,0.22343240282262125,0.7765675971773788
977,Jimmy Neutron: Boy Genius,102992536,80936232,22056304,2001,0.7858456072972123,0.21415439270278772
978,Resident Evil,102984862,40119709,62865153,2002,0.3895689931594024,0.6104310068405976
979,Jigsaw,102952888,38052832,64900056,2017,0.3696140316141496,0.6303859683858505
980,Just Like Heaven,102854431,48318130,54536301,2005,0.4697719828910434,0.5302280171089566
981,Love & Other Drugs,102820008,32367005,70453003,2010,0.31479286599549766,0.6852071340045023
982,Chappie,102811889,31569268,71242621,2015,0.3070585348354022,0.6929414651645979
983,Star Wars: Episode I - The Phantom Menace 2012 3D Release,102739593,43456382,59283211,2012,0.4229759991359903,0.5770240008640096
984,Project X,102731865,54731865,48000000,2012,0.5327642499238187,0.46723575007618134
985,Dawn of the Dead,102278712,59020957,43257755,2004,0.5770600337634287,0.4229399662365713
986,John Q,102244770,71756802,30487968,2002,0.7018139118509436,0.29818608814905645
987,Railroad Tigers,102205175,218044,101987131,2016,0.002133394908819441,0.9978666050911805
988,Heaven Is for Real,101888019,91443253,10444766,2014,0.8974877900020806,0.10251220999791938
989,The Devil Inside,101758490,53261944,48496546,2012,0.5234152354265477,0.4765847645734523
990,Just Married,101564935,56127162,45437773,2003,0.5526234226408947,0.4473765773591053
991,Miss Congeniality 2: Armed & Fabulous,101393569,48478006,52915563,2005,0.4781171673718281,0.5218828326281719
992,The Recruit,101191884,52802140,48389744,2003,0.5218021239727091,0.47819787602729086
993,Joy,101134059,56451232,44682827,2015,0.5581822044737669,0.4418177955262332
994,Kung Fu Hustle,100912445,17108591,83803854,2004,0.16953896023429024,0.8304610397657097
995,"Alexander and the Terrible, Horrible, No Good, Very Bad Day",100654149,66954149,33700000,2014,0.665190155251325,0.334809844748675
996,Ladder 49,100572044,74541707,26030337,2004,0.7411772102394578,0.2588227897605422
997,Life,100541806,30234022,70307784,2017,0.30071095003008,0.69928904996992
998,Instructions Not Included,100486616,44467206,56019410,2013,0.44251869323572407,0.557481306764276
999,Tammy,100375432,84525432,15850000,2014,0.8420928340313395,0.15790716596866053
1000,PK,100370104,10616104,89754000,2014,0.10576958254422054,0.8942304174557795
1001,Aftershock,100293273,62962,100230311,2010,0.0006277788940041871,0.9993722211059958
1002,Philomena,100129872,37709979,62419893,2013,0.376610678180034,0.623389321819966
1003,Don't Say a Word,100020092,55001642,45018450,2001,0.5499059328999617,0.45009406710003824
1004,Atomic Blonde,100014025,51687870,48326155,2017,0.5168062179279356,0.48319378207206437
1005,The Book of Life,99783556,50151543,49632013,2014,0.5026032846534353,0.4973967153465647
1006,Black Mass,99775678,62575678,37200000,2015,0.6271636460340565,0.3728363539659435
1007,Insidious,99557032,54009150,45547882,2011,0.5424945773795266,0.45750542262047345
1008,Line Walker 2: Invisible Spy,99482027,296751,99185276,2019,0.002982960932229497,0.9970170390677705
1009,The Lucky One,99357138,60457138,38900000,2012,0.6084830865397914,0.39151691346020856
1010,Hellboy,99318987,59623958,39695029,2004,0.600327890980201,0.399672109019799
1011,Shanghai Noon,99274467,56937502,42336965,2000,0.5735362145031713,0.42646378549682873
1012,Blue Jasmine,99104804,33405481,65699323,2013,0.3370722674553698,0.6629277325446302
1013,Ode To My Father,99085291,2300121,96785170,2014,0.023213546398122804,0.9767864536018772
1014,Justin Bieber: Never Say Never,99036827,73013910,26022917,2011,0.7372399965923787,0.2627600034076213
1015,Young Detective Dee: Rise of the Sea Dragon,98774891,87783,98687108,2013,0.0008887177612780155,0.999111282238722
1016,Spotlight,98690254,45055776,53634478,2015,0.45653723821604514,0.5434627617839549
1017,Devil and Angel,98599942,131058,98468884,2015,0.0013291894228497619,0.9986708105771502
1018,The Visit,98450062,65206105,33243957,2015,0.6623267032579421,0.3376732967420579
1019,Crash,98410061,54580300,43829761,2005,0.5546211377716757,0.4453788622283244
1020,Evolution,98376292,38345494,60030798,2001,0.38978389224102894,0.6102161077589711
1021,Riddick,98337295,42025135,56312160,2013,0.4273570368190421,0.572642963180958
1022,Alpha,98203196,35857181,62346015,2018,0.36513252582940375,0.6348674741705962
1023,Killers,98159963,47059963,51100000,2010,0.4794211566685289,0.5205788433314711
1024,Once Upon a Time in Mexico,98096026,56359780,41736246,2003,0.5745368318997958,0.4254631681002042
1025,Paul,97984015,37412945,60571070,2011,0.3818270255612612,0.6181729744387388
1026,Along With the Gods: The Last 49 Days,97962238,1200246,96761992,2018,0.012252129233715547,0.9877478707662845
1027,Are We There Yet?,97918663,82674398,15244265,2005,0.8443170634386623,0.15568293656133764
1028,Phone Booth,97837138,46566212,51270926,2003,0.4759564001146477,0.5240435998853523
1029,I Am Sam,97818139,40311852,57506287,2001,0.4121101915463757,0.5878898084536244
1030,A Simple Favor,97644617,53548586,44096031,2018,0.5484028474401206,0.4515971525598795
1031,Safe Haven,97594140,71349120,26245020,2013,0.7310799603336839,0.26892003966631606
1032,The Little Prince,97571250,1339152,96232098,2015,0.013724862600407395,0.9862751373995926
1033,Evil Dead,97542952,54239856,43303096,2013,0.5560612518677925,0.44393874813220746
1034,42,97470701,95020213,2450488,2013,0.9748592348792074,0.025140765120792555
1035,Scream 4,97138686,38180928,58957758,2011,0.39305584183010256,0.6069441581698974
1036,Jarhead,97076152,62658220,34417932,2005,0.6454543027210226,0.35454569727897745
1037,Enemy at the Gates,96976270,51401758,45574512,2001,0.530044700626246,0.469955299373754
1038,The Shack,96942115,57386418,39555697,2017,0.5919658138261168,0.40803418617388326
1039,The Butterfly Effect,96822421,57938693,38883728,2004,0.5984016140228512,0.4015983859771488
1040,Christmas with the Kranks,96572480,73780539,22791941,2004,0.7639913461888935,0.23600865381110644
1041,The Rite,96560591,33047633,63512958,2011,0.34224762563849676,0.6577523743615032
1042,13 Going on 30,96455697,57231747,39223950,2004,0.5933475033620875,0.4066524966379124
1043,Contraband,96262212,66528000,29734212,2012,0.6911123131057907,0.3088876868942093
1044,Red Eye,96258201,57891803,38366398,2005,0.6014220336405415,0.3985779663594586
1045,Kick-Ass,96188903,48071303,48117600,2010,0.4997593433413,0.5002406566587
1046,The Tigger Movie,96159800,45554533,50605267,2000,0.4737378093548448,0.5262621906451552
1047,Assassination,96119773,1904682,94215091,2015,0.019815714712518098,0.9801842852874819
1048,The Manchurian Candidate,96105910,65955630,30150280,2004,0.6862806876288877,0.3137193123711122
1049,The 6th Day,96085477,34604280,61481197,2000,0.36014058607420973,0.6398594139257903
1050,Think Like a Man,96070507,91547205,4523302,2012,0.9529168509540602,0.04708314904593977
1051,Dolphin Tale,95932565,72286779,23645786,2011,0.7535165874069978,0.2464834125930022
1052,The Favourite,95918706,34366783,61551923,2018,0.35829072798375744,0.6417092720162426
1053,Be Cool,95763716,56046979,39716737,2005,0.5852632013569733,0.41473679864302676
1054,Some Like It Hot,95721320,100026,95621294,2016,0.001044970963626494,0.9989550290363735
1055,Underworld,95708457,51970690,43737767,2003,0.5430104259229673,0.4569895740770327
1056,Poltergeist,95437994,47425125,48012869,2015,0.49692080703205055,0.5030791929679495
1057,The Mortal Instruments: City of Bones,95396573,31165421,64231152,2013,0.32669329746258285,0.6733067025374172
1058,Truth or Dare,95330493,41411015,53919478,2018,0.43439421843753606,0.565605781562464
1059,Rush,95224595,26947624,68276971,2013,0.28299016656358583,0.7170098334364142
1060,40 Days and 40 Nights,95146283,37950822,57195461,2002,0.3988681512655623,0.6011318487344377
1061,The Hustle,95031585,35417038,59614547,2019,0.37268701768996065,0.6273129823100393
1062,Changing Lanes,94935764,66818548,28117216,2002,0.7038290438153528,0.2961709561846471
1063,The Wedding Planner,94728529,60400856,34327673,2001,0.6376205419594344,0.3623794580405656
1064,I Feel Pretty,94539426,48795601,45743825,2018,0.5161402291568811,0.48385977084311893
1065,Veteran,94393020,1200627,93192393,2015,0.01271944684045494,0.9872805531595451
1066,Masquerade,94268432,922921,93345511,2012,0.009790350602203715,0.9902096493977963
1067,Police Story: Lockdown,94249025,0,94249025,2013,0.0,1.0
1068,Fleet of Time,94244191,569280,93674911,2014,0.006040478399353017,0.9939595216006469
1069,Dirty Grandpa,94073028,35593113,58479915,2016,0.378356195784407,0.6216438042155931
1070,Ben-Hur,94061311,26410477,67650834,2016,0.2807793844166174,0.7192206155833827
1071,Blockers,94017294,60311495,33705799,2018,0.6414936277574634,0.35850637224253656
1072,The Skeleton Key,93983911,47907715,46076196,2005,0.5097437900833899,0.49025620991661006
1073,Syriana,93974620,50824620,43150000,2005,0.540833471845909,0.459166528154091
1074,In the Heart of the Sea,93920758,25020758,68900000,2015,0.26640285420183685,0.7335971457981632
1075,Nothing to Declare,93811164,0,93811164,2011,0.0,1.0
1076,Kill Zone 2,93638358,11998,93626360,2015,0.00012813125151126635,0.9998718687484888
1077,The Internship,93492844,44672764,48820080,2013,0.4778201420421011,0.5221798579578989
1078,BlacKkKlansman,93400823,49275340,44125483,2018,0.5275685847008008,0.47243141529919924
1079,Calendar Girls,93400759,31041759,62359000,2003,0.3323501792956522,0.6676498207043479
1080,Goosebumps 2: Haunted Halloween,93320380,46700633,46619747,2018,0.5004333780038187,0.49956662199618135
1081,Money Monster,93282604,41012075,52270529,2016,0.43965405382551287,0.5603459461744872
1082,Nanny McPhee Returns,93251121,29011215,64239906,2010,0.3111084852266816,0.6888915147733183
1083,Secret Window,92913171,48022900,44890271,2004,0.5168578306298469,0.48314216937015314
1084,The Family Stone,92884429,60062868,32821561,2005,0.646640870236711,0.353359129763289
1085,House of Flying Daggers,92863945,11050094,81813851,2004,0.11899229566437222,0.8810077043356278
1086,Train to Busan,92688375,2129768,90558607,2016,0.022977725092278294,0.9770222749077218
1087,Four Brothers,92374674,74494381,17880293,2005,0.806437281716415,0.19356271828358496
1088,Downfall,92181574,5509040,86672534,2004,0.059762919648128375,0.9402370803518716
1089,Southpaw,91970827,52421953,39548874,2015,0.5699845778270538,0.4300154221729462
1090,Finding Nemo 2012 3D Release,91844526,41128283,50716243,2012,0.44780331274179586,0.5521966872582041
1091,Behind Enemy Lines,91753202,58856790,32896412,2001,0.6414685124558378,0.3585314875441622
1092,Get Him to the Greek,91720255,60974475,30745780,2010,0.6647874561622185,0.33521254383778154
1093,Shadow,91708374,521396,91186978,2018,0.005685369582498541,0.9943146304175015
1094,Season of the Witch,91627228,24827228,66800000,2011,0.2709590647007241,0.7290409352992759
1095,Crawl,91542097,39014193,52527904,2019,0.4261885436161682,0.5738114563838318
1096,Five Feet Apart,91522094,45729221,45792873,2019,0.49965225883052894,0.500347741169471
1097,Rambo: Last Blood,91490353,44819352,46671001,2019,0.4898806325514997,0.5101193674485003
1098,Overboard,91244913,50316123,40928790,2018,0.551440308787406,0.448559691212594
1099,White Noise,91196419,56386759,34809660,2005,0.6183001440001717,0.38169985599982825
1100,Romeo Must Die,91036760,55973336,35063424,2000,0.6148432347548397,0.3851567652451603
1101,Final Destination 2,90941129,46961214,43979915,2003,0.5163913678705264,0.4836086321294736
1102,Paranormal Activity: The Marked Ones,90894962,32462372,58432590,2014,0.35714159823291414,0.6428584017670859
1103,Fantasia 2000,90874570,60655420,30219150,2000,0.667463075753756,0.33253692424624404
1104,Racing Stripes,90754475,49772522,40981953,2005,0.5484304988817356,0.45156950111826444
1105,Autumn in New York,90726668,37761915,52964753,2000,0.4162162662030088,0.5837837337969912
1106,Anchorman: The Legend of Ron Burgundy,90649730,85288303,5361427,2004,0.9408555657032845,0.0591444342967155
1107,My Big Fat Greek Wedding 2,90632641,59689605,30943036,2016,0.6585883887020351,0.34141161129796493
1108,Sherlock Gnomes,90497778,43242871,47254907,2018,0.4778335110062039,0.522166488993796
1109,Bring It On,90449929,68379000,22070929,2000,0.7559873264245459,0.24401267357545411
1110,Bedazzled,90383208,37886980,52496228,2000,0.4191816249761792,0.5808183750238208
1111,Jojo Rabbit,90335025,33370906,56964119,2019,0.369412705647671,0.630587294352329
1112,Red Riding Hood,90260376,37662162,52598214,2011,0.4172613019028416,0.5827386980971584
1113,Identity,90259536,52159536,38100000,2003,0.5778839368285695,0.42211606317143047
1114,Detective Dee: The Four Heavenly Kings,90040771,262963,89777808,2018,0.0029204880975530517,0.9970795119024469
1115,Sucker Punch,89792502,36392502,53400000,2011,0.4052955557469598,0.5947044442530401
1116,Burlesque,89519773,39440655,50079118,2010,0.4405803732321797,0.5594196267678203
1117,The Hundred-Foot Journey,89514453,54240821,35273632,2014,0.6059448411085079,0.39405515889149206
1118,The Purge,89328627,64473115,24855512,2013,0.7217519978226017,0.2782480021773983
1119,The Last Song,89137047,62950384,26186663,2010,0.7062202094265025,0.29377979057349746
1120,Transporter 2,89083229,43095856,45987373,2005,0.4837706994208753,0.5162293005791248
1121,Rumor Has It...,88933562,43000262,45933300,2005,0.4835099486963088,0.5164900513036912
1122,Kangaroo Jack,88929111,66934963,21994148,2003,0.7526777480098727,0.24732225199012728
1123,The Inbetweeners,88823111,36000,88787111,2011,0.00040529992244923735,0.9995947000775508
1124,Collateral Beauty,88528280,31016021,57512259,2016,0.350351559976089,0.649648440023911
1125,Shanghai Knights,88323487,60476872,27846615,2003,0.6847201582971922,0.31527984170280776
1126,This Is 40,88215156,67544505,20670651,2012,0.7656791424820469,0.23432085751795304
1127,Dhoom 3,88031955,8031955,80000000,2013,0.09123908471645324,0.9087609152835467
1128,Chasing the Dragon,87965942,456854,87509088,2017,0.005193532742478902,0.9948064672575211
1129,Deliver Us from Evil,87937815,30577122,57360693,2014,0.3477130060600209,0.652286993939979
1130,Gosford Park,87754044,41308615,46445429,2001,0.47073175339930773,0.5292682466006923
1131,Ali,87713825,58203105,29510720,2001,0.6635567996265127,0.3364432003734873
1132,Tiger Zinda Hai,87320000,5560921,81759079,2017,0.06368439074667888,0.9363156092533211
1133,Pain & Gain,87305549,49875291,37430258,2013,0.5712728637672274,0.42872713623277253
1134,Sultan,87280000,6200000,81080000,2016,0.07103574702108158,0.9289642529789184
1135,A Million Ways to Die in the West,87189756,43139300,44050456,2014,0.49477486781818725,0.5052251321818128
1136,Old School,87135520,75585093,11550427,2003,0.8674429555249111,0.13255704447508893
1137,The Thieves,87126367,685839,86440528,2012,0.007871773191231536,0.9921282268087684
1138,About Time,87100449,15322921,71777528,2013,0.17592241114623874,0.8240775888537613
1139,Dinner for Schmucks,86855739,73026337,13829402,2010,0.8407773376955552,0.15922266230444485
1140,Snowpiercer,86758912,4563650,82195262,2013,0.052601512568530136,0.9473984874314698
1141,The Lincoln Lawyer,86752352,58009200,28743152,2011,0.6686758187259292,0.3313241812740708
1142,Robin Hood,86489031,30824628,55664403,2018,0.35639927564918605,0.643600724350814
1143,Tears of the Sun,86468162,43734876,42733286,2003,0.5057916693082941,0.49420833069170594
1144,Sky High,86369815,63946815,22423000,2005,0.7403838366447815,0.2596161633552185
1145,A Taxi Driver,86252940,1527829,84725111,2017,0.01771335562590678,0.9822866443740932
1146,War Dogs,86234523,43034523,43200000,2016,0.4990405408747956,0.5009594591252045
1147,Step Up All In,86165646,14904384,71261262,2014,0.1729736233858213,0.8270263766141787
1148,The Dark Knight 2012 Re-release,86157750,1513086,84644664,2012,0.017561809587645916,0.982438190412354
1149,Hall Pass,86157237,45060734,41096503,2011,0.523005792305062,0.47699420769493805
1150,I Can Only Imagine,86075110,83482352,2592758,2018,0.9698779589128611,0.030122041087138895
1151,John Wick,86013056,43037835,42975221,2014,0.5003639796265348,0.49963602037346516
1152,The Second Best Exotic Marigold Hotel,85978266,33078266,52900000,2015,0.38472822887588826,0.6152717711241118
1153,Match Point,85638656,23151529,62487127,2005,0.2703397050042448,0.7296602949957552
1154,Spy Kids 4-D: All the Time in the World,85564310,38538188,47026122,2011,0.45040026618574963,0.5495997338142503
1155,Paper Towns,85512300,32000304,53511996,2015,0.37421872642882953,0.6257812735711704
1156,Rat Race,85498534,56618055,28880479,2001,0.6622108280827365,0.33778917191726354
1157,The Possession,85446075,49130154,36315921,2012,0.5749843278348362,0.42501567216516384
1158,Nerve,85251425,38583626,46667799,2016,0.4525862881470896,0.5474137118529103
1159,Final Fantasy: The Spirits Within,85131830,32131830,53000000,2001,0.3774361481481133,0.6225638518518867
1160,J. Edgar,84920539,37306030,47614509,2011,0.4393051485459837,0.5606948514540163
1161,Going in Style,84918541,45018541,39900000,2017,0.5301379471416025,0.46986205285839755
1162,Sicario,84872444,46889293,37983151,2015,0.5524678068655593,0.44753219313444065
1163,Carrie,84790678,35266619,49524059,2013,0.41592566343201076,0.5840743365679892
1164,The Animal,84772742,57743062,27029680,2001,0.6811512832745223,0.31884871672547765
1165,The Judge,84419388,47119388,37300000,2014,0.5581583699706517,0.44184163002934823
1166,What to Expect When You're Expecting,84384002,41152203,43231799,2012,0.4876777828100639,0.5123222171899361
1167,Leap!,84197417,2844490,81352927,2016,0.0337835779451524,0.9662164220548476
1168,Finding Mr. Right,84112033,6945,84105088,2013,8.256844772733052e-05,0.9999174315522726
1169,Marmaduke,83761844,33644788,50117056,2010,0.40167200712534457,0.5983279928746554
1170,In Her Shoes,83697473,32880591,50816882,2005,0.3928504627612831,0.6071495372387169
1171,Mortal Engines,83672673,15951040,67721633,2018,0.19063619492591088,0.8093638050740891
1172,Snatch,83557872,30328156,53229716,2000,0.3629598896439105,0.6370401103560895
1173,Blow,83282296,52990775,30291521,2001,0.6362789877935162,0.36372101220648384
1174,Piranha 3D,83188165,25003155,58185010,2010,0.30056144404675833,0.6994385559532417
1175,Rings,83080890,27793018,55287872,2017,0.33452961324800445,0.6654703867519955
1176,Savages,82966152,47382068,35584084,2012,0.5711011883496778,0.4288988116503222
1177,Once Upon A Time,82886178,485728,82400450,2017,0.005860180933906736,0.9941398190660933
1178,28 Days Later...,82719885,45064915,37654970,2002,0.5447893816583521,0.45521061834164783
1179,"Big Mommas: Like Father, Like Son",82686066,37915414,44770652,2011,0.4585465947793429,0.5414534052206571
1180,Oceans 2010 Re-release,82651439,19422319,63229120,2010,0.2349906938704358,0.7650093061295642
1181,Sinister,82515113,48086903,34428210,2012,0.5827647960683275,0.4172352039316725
1182,Act of Valor,82497035,70012847,12484188,2012,0.8486710704208945,0.1513289295791055
1183,The Constant Gardener,82466670,33579797,48886873,2005,0.4071923481328881,0.5928076518671119
1184,Hitman: Agent 47,82347656,22467450,59880206,2015,0.2728365455842483,0.7271634544157517
1185,Men of Honor,82343495,48818921,33524574,2000,0.5928691877846575,0.4071308122153426
1186,Reign of Fire,82150183,43061982,39088201,2002,0.5241860751545739,0.4758139248454261
1187,Catwoman,82102379,40202379,41900000,2004,0.48966156023323026,0.5103384397667697
1188,Abduction,82087155,28087155,54000000,2011,0.34216260753585626,0.6578373924641437
1189,The Chorus,82032134,2087128,79945006,2004,0.025442810009063035,0.974557189990937
1190,Ouija: Origin of Evil,81705746,35144505,46561241,2016,0.43013504827432825,0.5698649517256718
1191,One Piece: Stampede,81562741,1298528,80264213,2019,0.01592060276640286,0.9840793972335972
1192,Frankenweenie,81491068,35291068,46200000,2012,0.43306670124877983,0.5669332987512202
1193,Tinker Tailor Soldier Spy,81244605,24149393,57095212,2011,0.297243035399089,0.7027569646009111
1194,Edge of Darkness,81126522,43313890,37812632,2010,0.5339054224461884,0.46609457755381156
1195,Underworld: Blood Wars,81093313,30353973,50739340,2016,0.37430919858953104,0.625690801410469
1196,Sinbad: Legend of the Seven Seas,80773077,26483452,54289625,2003,0.32787474469989547,0.6721252553001045
1197,A Dog's Way Home,80708134,42004346,38703788,2019,0.5204474929379485,0.4795525070620515
1198,The Rookie,80693537,75600072,5093465,2002,0.9368788977486512,0.06312110225134883
1199,The Rundown,80657921,47726342,32931579,2003,0.5917130197293332,0.4082869802706668
1200,Go Away Mr. Tumor,80606893,286639,80320254,2015,0.0035560110225312867,0.9964439889774687
1201,Vampires Suck,80547866,36661504,43886362,2010,0.4551517727359779,0.5448482272640222
1202,Den of Thieves,80509622,44947622,35562000,2018,0.5582888216764947,0.44171117832350526
1203,Muppets Most Wanted,80383113,51183113,29200000,2014,0.6367396221641727,0.36326037783582726
1204,Hereditary,80200936,44069456,36131480,2018,0.5494880508626483,0.4505119491373517
1205,Runaway Jury,80154140,49443628,30710512,2003,0.6168568211199073,0.3831431788800928
1206,Finding Forrester,80049764,51804714,28245050,2000,0.6471563613854002,0.3528436386145998
1207,Exit Wounds,79958599,51758599,28200000,2001,0.6473174823886046,0.35268251761139535
1208,The Wedding Ringer,79799880,64460211,15339669,2015,0.8077732823658381,0.19222671763416185
1209,The Grey,79781695,51580236,28201459,2012,0.6465171741462751,0.353482825853725
1210,Jackass: The Movie,79493831,64255312,15238519,2002,0.8083056407232405,0.19169435927675949
1211,Good Bye Lenin!,79316957,4064200,75252757,2003,0.05123998894713018,0.9487600110528698
1212,Letters to Juliet,79293444,53032453,26260991,2010,0.6688125817816666,0.3311874182183334
1213,Stealth,79268322,32116746,47151576,2005,0.40516495353591564,0.5948350464640844
1214,Manchester by the Sea,78988148,47695371,31292777,2016,0.603829463124012,0.396170536875988
1215,Lady Bird,78965611,48958273,30007338,2017,0.6199948608008617,0.3800051391991382
1216,Paranormal Activity: The Ghost Dimension,78903124,18300124,60603000,2015,0.2319315519116835,0.7680684480883165
1217,The Boss,78844582,63285885,15558697,2016,0.8026662504216207,0.1973337495783794
1218,The Attorney,78547586,557236,77990350,2013,0.007094247301247424,0.9929057526987526
1219,The Family,78418811,36918811,41500000,2013,0.47079024189744473,0.5292097581025552
1220,Collateral Damage,78382433,40077257,38305176,2002,0.5113040698800457,0.4886959301199543
1221,Scary Movie V,78378744,32015787,46362957,2013,0.4084753769465864,0.5915246230534136
1222,R.I.P.D.,78324220,33618855,44705365,2013,0.4292268087700075,0.5707731912299925
1223,Priest,78309505,29137000,49172505,2011,0.37207488414082046,0.6279251158591795
1224,If I Stay,78274843,50474843,27800000,2014,0.6448411911857811,0.3551588088142189
1225,Tag,78130625,54730625,23400000,2018,0.7005015638874001,0.2994984361125999
1226,Exorcist: The Beginning,78110021,41821986,36288035,2004,0.5354240783010416,0.46457592169895845
1227,Shin Godzilla,77947607,1918403,76029204,2016,0.024611441888139043,0.975388558111861
1228,Showtime,77741732,38082712,39659020,2002,0.4898618929663157,0.5101381070336843
1229,Tiny Times,77717014,23462,77693552,2013,0.0003018901369525082,0.9996981098630475
1230,Windtalkers,77628265,40914068,36714197,2002,0.5270511713742411,0.47294882862575893
1231,Hostage,77608617,34639939,42968678,2005,0.4463414030429121,0.5536585969570879
1232,Serendipity,77516304,50294317,27221987,2001,0.6488224335360468,0.3511775664639532
1233,The Back-up Plan,77477008,37490007,39987001,2010,0.48388558060992753,0.5161144193900725
1234,Diary of a Wimpy Kid: Dog Days,77229695,49008662,28221033,2012,0.6345831354118386,0.3654168645881613
1235,Mike and Dave Need Wedding Dates,77068246,46009673,31058573,2016,0.596999093504736,0.40300090649526393
1236,Barbershop,77063924,75782105,1281819,2002,0.983366808573101,0.01663319142689905
1237,Drive,76976666,35061555,41915111,2011,0.45548289919441304,0.544517100805587
1238,"I, Frankenstein",76801179,19075290,57725889,2014,0.248372358971208,0.751627641028792
1239,Sanju,76693052,7909317,68783735,2018,0.10312951165380665,0.8968704883461933
1240,Coach Carter,76669554,67264877,9404677,2005,0.8773349196735903,0.12266508032640962
1241,The Ladykillers,76665191,39799191,36866000,2004,0.519129874730241,0.480870125269759
1242,The Book Thief,76586316,21488481,55097835,2013,0.28057859578987976,0.7194214042101202
1243,Bend It Like Beckham,76583333,32543449,44039884,2002,0.4249416645264055,0.5750583354735945
1244,Bad Santa,76488889,60060328,16428561,2003,0.7852163730604061,0.2147836269395938
1245,The Road to El Dorado,76432727,50863742,25568985,2000,0.665470721723693,0.33452927827630696
1246,Cold Pursuit,76419755,32138862,44280893,2019,0.42055698817668286,0.5794430118233171
1247,The Ides of March,76338111,40962534,35375577,2011,0.5365934978401549,0.4634065021598452
1248,Kubo and the Two Strings,76249438,48023088,28226350,2016,0.6298156322148892,0.37018436778511077
1249,Diary of a Wimpy Kid,76196538,64003625,12192913,2010,0.8399807482066968,0.16001925179330326
1250,Tae Guk Gi: The Brotherhood of War,76194339,1111061,75083278,2004,0.014581936329941782,0.9854180636700582
1251,The Mechanic,76130093,29121498,47008595,2011,0.38252282182290254,0.6174771781770975
1252,If You Are the One 2,76085443,426894,75658549,2010,0.005610718465554574,0.9943892815344454
1253,Vice,76073488,47836282,28237206,2018,0.6288167304751426,0.3711832695248573
1254,Kate & Leopold,76019048,47121859,28897189,2001,0.6198691017546023,0.38013089824539764
1255,Widows,75984700,42402632,33582068,2018,0.5580417110286676,0.4419582889713324
1256,Sicario: Day of the Soldado,75837743,50072235,25765508,2018,0.6602548153364743,0.33974518466352566
1257,Dreamcatcher,75715436,33715436,42000000,2003,0.44529144625146183,0.5547085537485381
1258,A Dog's Journey,75670834,22782371,52888463,2019,0.30107202201577427,0.6989279779842257
1259,Bajrangi Bhaijaan,75547184,8178001,67369183,2015,0.10825024265629808,0.8917497573437019
1260,Der Schuh des Manitu,75482094,0,75482094,2001,0.0,1.0
1261,Searching,75462037,26020957,49441080,2018,0.3448218208050758,0.6551781791949242
1262,The Change-Up,75450437,37081475,38368962,2011,0.49146799507602584,0.5085320049239741
1263,The Count of Monte Cristo,75395048,54234062,21160986,2002,0.719331885033086,0.280668114966914
1264,The Spy Who Dumped Me,75320680,33562069,41758611,2018,0.4455890334500432,0.5544109665499568
1265,Larry Crowne,75055070,35608245,39446825,2011,0.47442824315532584,0.5255717568446742
1266,Easy A,75026216,58401464,16624752,2010,0.7784140946146078,0.22158590538539222
1267,Tyler Perry's Boo! A Madea Halloween,74827344,73206343,1621001,2016,0.9783367828744529,0.021663217125547047
1268,A Madea Family Funeral,74747725,73257045,1490680,2019,0.9800571856869222,0.019942814313077754
1269,Crimson Peak,74679822,31090320,43589502,2014,0.4163148648104705,0.5836851351895295
1270,Escape from Planet Earth,74597643,57012977,17584666,2013,0.7642731687916735,0.23572683120832652
1271,From Hell,74558115,31602566,42955549,2001,0.4238648737297074,0.5761351262702926
1272,Hubble 3D,74249729,52522904,21726825,2010,0.7073817602755156,0.29261823972448436
1273,August: Osage County,74188937,37738810,36450127,2013,0.5086851426379111,0.4913148573620889
1274,Eternal Sunshine of the Spotless Mind,74036715,34400301,39636414,2004,0.4646384027168142,0.5353615972831858
1275,Miracles from Heaven,73983003,61705123,12277880,2016,0.8340445845378837,0.16595541546211634
1276,Divine Secrets of the Ya-Ya Sisterhood,73839240,69599016,4240224,2002,0.94257492357722,0.05742507642278008
1277,Cats,73736092,27166770,46569322,2019,0.3684324631687831,0.6315675368312169
1278,The Core,73498611,31186896,42311715,2003,0.4243195289772211,0.575680471022779
1279,Charlie's Angels,73279888,17803077,55476811,2019,0.24294629107511737,0.7570537089248827
1280,War Room,73267874,67790117,5477757,2015,0.9252365777666758,0.07476342223332426
1281,To Rome With Love,73244881,16685867,56559014,2012,0.22780932636097806,0.7721906736390219
1282,"Dude, Where's My Car?",73180723,46729800,26450923,2000,0.6385534070222291,0.36144659297777093
1283,Here Comes the Boom,73100172,45290318,27809854,2012,0.6195651359069305,0.3804348640930694
1284,Without a Paddle,73029190,58169327,14859863,2004,0.7965215963644127,0.20347840363558736
1285,The Best Man Holiday,72835710,70525195,2310515,2013,0.9682777170703766,0.0317222829296234
1286,The One,72689126,43905746,28783380,2001,0.6040208269941229,0.3959791730058771
1287,"Yours, Mine & Ours",72662923,53412862,19250061,2005,0.7350772552874043,0.26492274471259575
1288,The Transporter Refueled,72629670,16029670,56600000,2015,0.22070415575342694,0.779295844246573
1289,Lord of War,72617068,24149632,48467436,2005,0.3325613752403223,0.6674386247596777
1290,Diary of a Wimpy Kid: Rodrick Rules,72526996,52698535,19828461,2011,0.7266057868989914,0.27339421310100864
1291,Doctor Sleep,72381712,31581712,40800000,2019,0.4363217051290525,0.5636782948709476
1292,Second Act,72282227,39282227,33000000,2018,0.5434562357908536,0.45654376420914644
1293,What Men Want,72216294,54611903,17604391,2019,0.7562268841987377,0.24377311580126224
1294,Around the World in 80 Days,72178895,24008137,48170758,2004,0.33261990225813237,0.6673800977418676
1295,The Adventures of Sharkboy and Lavagirl 3-D,71992655,39177684,32814971,2005,0.5441900149397185,0.4558099850602815
1296,"O Brother, Where Art Thou?",71868327,45512588,26355739,2000,0.6332774102282915,0.36672258977170846
1297,Rules of Engagement,71732303,61335230,10397073,2000,0.8550573093965769,0.14494269060342313
1298,Run All Night,71561644,26461644,45100000,2015,0.3697741208963841,0.6302258791036159
1299,The Royal Tenenbaums,71441250,52364010,19077240,2001,0.7329660385281612,0.2670339614718387
1300,Brick Mansions,71416730,20396829,51019901,2014,0.28560295325759105,0.714397046742409
1301,Holes,71406573,67406573,4000000,2003,0.9439827479187385,0.05601725208126148
1302,Down to Earth,71186502,64186502,7000000,2001,0.9016667513737365,0.09833324862626344
1303,xXx: State of the Union,71022693,26873932,44148761,2005,0.37838514515353566,0.6216148548464644
1304,The Counselor,71009334,16973715,54035619,2013,0.23903498376706364,0.7609650162329363
1305,Anacondas: The Hunt for the Blood Orchid,70992898,32238923,38753975,2004,0.45411476229636377,0.5458852377036362
1306,Son of God,70829270,59700064,11129206,2014,0.842872784090532,0.15712721590946793
1307,I Am Not Madame Bovary,70826207,436798,70389409,2016,0.006167180461887504,0.9938328195381125
1308,Taxi 2004 Re-release,70778329,36611066,34167263,2004,0.5172637799911891,0.4827362200088109
1309,Brotherhood of the Wolf,70752904,11260096,59492808,2001,0.15914676802523894,0.840853231974761
1310,Spirited Away 2018 Re-release,70186029,1175067,69010962,2018,0.016742178133485795,0.9832578218665142
1311,Think Like a Man Too,70181428,65182182,4999246,2014,0.9287668241803231,0.07123317581967696
1312,A Cinderella Story,70067909,51438175,18629734,2004,0.7341188817265832,0.2658811182734167
1313,The Cabin in the Woods 2012 Re-release,69935600,42073277,27862323,2012,0.6016002865493397,0.39839971345066033
1314,After,69733482,12138565,57594917,2019,0.17407082870177054,0.8259291712982294
1315,The Dilemma,69721966,48475290,21246676,2011,0.6952656785380952,0.3047343214619048
1316,Exit,69501772,470699,69031073,2019,0.006772474808268198,0.9932275251917319
1317,The Last Exorcism,69432527,41034350,28398177,2010,0.5909960615433167,0.40900393845668326
1318,A Very Long Engagement,69424389,6524389,62900000,2004,0.0939783423949183,0.9060216576050817
1319,13 Hours,69411370,52853219,16558151,2015,0.7614490104431018,0.23855098955689824
1320,E.T. the Extra-Terrestrial 20th Anniversary,69177751,35306015,33871736,2002,0.5103666206205518,0.4896333793794482
1321,Takers,69055695,57744720,11310975,2010,0.8362050371080908,0.1637949628919092
1322,Anna Karenina,68929150,12816367,56112783,2012,0.18593536986891612,0.8140646301310839
1323,Running Man,68782475,310978,68471497,2015,0.004521180722269735,0.9954788192777303
1324,House of Wax,68766121,32064800,36701321,2005,0.46628775236573256,0.5337122476342675
1325,The Nut Job 2: Nutty by Nature,68743485,28370522,40372963,2017,0.41270124725273966,0.5872987527472603
1326,The Sweetest Thing,68696770,24718164,43978606,2002,0.35981551971075204,0.6401844802892479
1327,Playing with Fire,68631669,44451847,24179822,2019,0.6476871049136224,0.3523128950863777
1328,The Call,68572631,51872378,16700253,2013,0.7564589143444124,0.24354108565558757
1329,One Direction: This Is Us,68532898,28873374,39659524,2013,0.4213067715303678,0.5786932284696322
1330,Looney Tunes: Back in Action,68514844,20991364,47523480,2003,0.3063768779799017,0.6936231220200983
1331,Thir13en Ghosts,68467960,41867960,26600000,2001,0.6114971148548898,0.3885028851451102
1332,Pokémon 3 the Movie: Spell of the Unown,68411275,17052128,51359147,2001,0.24925902930474544,0.7507409706952546
1333,Ghost Ship,68349884,30113491,38236393,2002,0.4405785238786945,0.5594214761213054
1334,Stalingrad,68316452,1013945,67302507,2013,0.014841886109659207,0.9851581138903408
1335,Open Range,68296293,58331254,9965039,2003,0.8540910705065646,0.1459089294934353
1336,The Watch,68267862,35353000,32914862,2012,0.5178571433802922,0.4821428566197078
1337,Moonrise Kingdom,68263166,45512466,22750700,2012,0.6667207026407185,0.3332792973592816
1338,Frequency,68106245,45010278,23095967,2000,0.6608832714239348,0.33911672857606523
1339,Shoplifters,67999335,3313513,64685822,2018,0.04872860889007223,0.9512713911099278
1340,Prime,67937494,22827153,45110341,2005,0.33600228174445174,0.6639977182555482
1341,Legion,67918658,40168080,27750578,2010,0.591414512342102,0.4085854876578981
1342,The American,67876281,35606376,32269905,2010,0.5245775913975016,0.4754224086024984
1343,A Beautiful Day in the Neighborhood,67760877,61704055,6056822,2019,0.9106147637374882,0.08938523626251177
1344,Jersey Boys,67647013,47047013,20600000,2014,0.6954780545890474,0.30452194541095257
1345,Bandits,67631903,41575141,26056762,2001,0.614726765857823,0.38527323414217696
1346,12 Strong,67450815,45819713,21631102,2018,0.6793055502739292,0.32069444972607075
1347,The Next Three Days,67448651,21148651,46300000,2010,0.3135518751887269,0.6864481248112732
1348,Star Trek: Nemesis,67336470,43254409,24082061,2002,0.6423622889646576,0.35763771103534236
1349,Harry Potter IMAX Marathon,67310392,1729226,65581166,2016,0.025690327282598503,0.9743096727174015
1350,American Assassin,67234188,36249674,30984514,2017,0.5391553773208356,0.4608446226791644
1351,Boogeyman,67192859,46752382,20440477,2005,0.6957939086949702,0.3042060913050299
1352,War,67179155,4654000,62525155,2019,0.06927744178979328,0.9307225582102068
1353,Skyline,66984887,21393620,45591267,2010,0.31937980279044137,0.6806201972095586
1354,The Giver,66980456,45090374,21890082,2014,0.6731870263767687,0.32681297362323125
1355,Madea's Witness Protection,66899242,65653242,1246000,2012,0.9813749758181116,0.018625024181888338
1356,Selma,66787908,52076908,14711000,2014,0.779735577284439,0.22026442271556101
1357,Thirteen Days,66579890,34592089,31987801,2000,0.5195576171723925,0.48044238282760754
1358,Victoria & Abdul,66558465,22245070,44313395,2017,0.33421849497280326,0.6657815050271968
1359,Not Another Teen Movie,66468332,38252284,28216048,2001,0.5754963732202577,0.4245036267797423
1360,"Love, Simon",66316289,40826341,25489948,2018,0.615630663531248,0.38436933646875204
1361,Mile 22,66308758,36108758,30200000,2018,0.5445548836851989,0.4554451163148011
1362,One Piece Film: Gold,66207073,423593,65783480,2016,0.00639800221949096,0.9936019977805091
1363,Barbershop 2: Back in Business,65991448,65111277,880171,2004,0.9866623475211516,0.013337652478848471
1364,Bad Company,65977295,30160161,35817134,2002,0.45712939580199524,0.5428706041980048
1365,Life of the Party,65859911,53059911,12800000,2018,0.8056480823364611,0.1943519176635389
1366,Beijing Love Story,65842375,428318,65414057,2014,0.0065052027664554936,0.9934947972335445
1367,Stuck on You,65784503,33832741,31951762,2003,0.5142965205650334,0.4857034794349666
1368,Sweet November,65754228,25288103,40466125,2001,0.384585201121972,0.6154147988780281
1369,K-19: The Widowmaker,65716126,35168966,30547160,2002,0.5351649304464478,0.4648350695535522
1370,The Age of Adaline,65663276,42629776,23033500,2015,0.6492179281460158,0.35078207185398425
1371,Matchstick Men,65565672,36906460,28659212,2003,0.5628930334154129,0.43710696658458714
1372,Taxi 3,65497208,497208,65000000,2003,0.007591285417845597,0.9924087145821544
1373,Taking Lives,65470529,32682342,32788187,2004,0.4991916591967662,0.5008083408032338
1374,Moonlight,65336603,27854932,37481671,2016,0.42632966394044086,0.5736703360595592
1375,Something Borrowed,65100369,39046489,26053880,2011,0.5997890580312993,0.40021094196870066
1376,Zathura: A Space Adventure,65079104,29258869,35820235,2005,0.44958930288898874,0.5504106971110112
1377,K-PAX,65001485,50338485,14663000,2001,0.7744205382384726,0.22557946176152746
1378,The Pirates,64858224,415775,64442449,2014,0.006410520892462304,0.9935894791075377
1379,Hot Tub Time Machine,64735752,50287556,14448196,2010,0.7768127262969,0.22318727370309996
1380,God's Not Dead,64667874,60755732,3912142,2014,0.9395040882277961,0.060495911772203925
1381,The Darkest Hour,64626786,21443494,43183292,2011,0.3318050506178661,0.6681949493821339
1382,Happy Death Day 2U,64600152,28148130,36452022,2019,0.43572854131984085,0.5642714586801592
1383,Monster Trucks,64493915,33370166,31123749,2016,0.5174157282900255,0.4825842717099745
1384,Miracle,64445708,64378093,67615,2004,0.9989508222952567,0.0010491777047433478
1385,Kiss of the Dragon,64437847,36845124,27592723,2001,0.5717932195965517,0.4282067804034483
1386,Fences,64414761,57682904,6731857,2016,0.8954920130806664,0.10450798691933359
1387,Capernaum,64413178,1661096,62752082,2018,0.02578813919102082,0.9742118608089791
1388,Zhongkui: Snow Girl and the Dark Crystal,64325947,165428,64160519,2015,0.002571714956641058,0.9974282850433589
1389,Isle of Dogs,64241499,32015231,32226268,2018,0.49835747139088393,0.5016425286091161
1390,Thunder and the House of Magic,64197205,4091,64193114,2013,6.372551577595941e-05,0.9999362744842241
1391,The Danish Girl,64191523,11114018,53077505,2015,0.1731384064528271,0.8268615935471729
1392,The Boy,64188367,35819556,28368811,2015,0.5580381255064488,0.4419618744935511
1393,The Grandmaster,64076736,6594959,57481777,2013,0.10292282990194757,0.8970771700980524
1394,Hanna,63782078,40259119,23522959,2011,0.6311979832328448,0.3688020167671552
1395,High Crimes,63781810,41543917,22237893,2002,0.651344278251119,0.34865572174888104
1396,"Hail, Caesar!",63647656,30498085,33149571,2016,0.4791705919225054,0.5208294080774947
1397,Elite Squad 2: The Enemy Within,63618850,100119,63518731,2010,0.0015737316848701288,0.9984262683151298
1398,Footloose 2011 Re-release,63543328,51802742,11740586,2011,0.815234952755386,0.18476504724461396
1399,Conan the Barbarian,63523283,21295021,42228262,2011,0.33523174487061697,0.664768255129383
1400,Begin Again,63464861,16170632,47294229,2014,0.25479661887229216,0.7452033811277078
1401,Colombiana,63458440,36665854,26792586,2011,0.5777931824356224,0.42220681756437756
1402,Side Effects,63414135,32172757,31241378,2013,0.5073436229950941,0.49265637700490594
1403,The Host,63365859,26627201,36738658,2013,0.42021368320754554,0.5797863167924544
1404,Jeepers Creepers 2,63102666,35667218,27435448,2003,0.5652252156826464,0.43477478431735356
1405,The Longest Ride,62944815,37446117,25498698,2015,0.5949039170263667,0.4050960829736333
1406,Unfriended,62882090,32482090,30400000,2015,0.5165555088897331,0.4834444911102668
1407,Piglet's Big Movie,62870546,23103423,39767123,2003,0.36747609922140645,0.6325239007785936
1408,The Mountain Between Us,62832209,30348555,32483654,2017,0.48300951825519933,0.5169904817448007
1409,The Star,62812974,40852824,21960150,2017,0.65038830990553,0.34961169009446996
1410,The Nice Guys,62788218,36261763,26526455,2016,0.5775249585837904,0.4224750414162097
1411,Beauty and the Beast 2012 3D Release,62767829,47617067,15150762,2012,0.7586221757008674,0.2413778242991326
1412,Proof of Life,62761005,32598931,30162074,2000,0.5194137824912141,0.4805862175087859
1413,Devil,62695489,33601190,29094299,2010,0.5359427055429777,0.46405729445702226
1414,Runner Runner,62675095,19316646,43358449,2013,0.3082028994132358,0.6917971005867641
1415,After the Sunset,62657868,28331233,34326635,2004,0.45215762847213375,0.5478423715278662
1416,How to Be a Latin Lover,62547032,32149404,30397628,2017,0.5140036700702281,0.4859963299297719
1417,Snow Day,62464731,60020107,2444624,2000,0.9608639313599221,0.03913606864007787
1418,Like Mike,62274780,51432760,10842020,2002,0.8259003082788892,0.17409969172111087
1419,Honey,62228395,30308417,31919978,2003,0.4870512408362774,0.5129487591637226
1420,28 Days,62198945,37170488,25028457,2000,0.5976064063466028,0.40239359365339716
1421,47 Meters Down,62187529,44307191,17880338,2017,0.7124771109654477,0.28752288903455225
1422,Two Brothers,62172050,19176754,42995296,2004,0.30844654470939914,0.6915534552906009
1423,Captain Corelli's Mandolin,62112895,25543895,36569000,2001,0.41124946760250025,0.5887505323974997
1424,Brooklyn,62076141,38322743,23753398,2015,0.6173506017392415,0.3826493982607585
1425,Friday Night Lights,61950770,61255921,694849,2004,0.9887838520812574,0.011216147918742576
1426,"Dragon Ball Z: Resurrection ""F""",61768190,8008363,53759827,2015,0.1296518968744268,0.8703481031255732
1427,Valiant,61746888,19478106,42268782,2005,0.3154508126790131,0.6845491873209869
1428,White Snake,61631776,34730,61597046,2019,0.000563508018980339,0.9994364919810197
1429,"Everything, Everything",61621140,34121140,27500000,2017,0.5537245821807256,0.4462754178192744
1430,Woman in Gold,61619773,33307793,28311980,2015,0.540537418078447,0.459462581921553
1431,The Face Reader,61559184,515876,61043308,2013,0.008380163063889865,0.9916198369361101
1432,Krampus,61548707,42725475,18823232,2015,0.694173396688902,0.305826603311098
1433,From Up on Poppy Hill,61459425,1002895,60456530,2011,0.0163180016734618,0.9836819983265382
1434,A History of Violence,61385065,31504633,29880432,2005,0.5132296104923894,0.4867703895076107
1435,In Good Company,61315215,45806659,15508556,2004,0.7470683907738072,0.2529316092261929
1436,The Legend of Hercules,61279452,18848538,42430914,2013,0.30758333152195944,0.6924166684780406
1437,The Walk,61181942,10137502,51044440,2014,0.16569434817874856,0.8343056518212515
1438,Crossroads,61141030,37191304,23949726,2002,0.6082871682076668,0.39171283179233324
1439,Ma,61105672,45896028,15209644,2019,0.7510927627144007,0.24890723728559927
1440,Snatched,60845711,45852178,14993533,2017,0.7535811028652455,0.24641889713475448
1441,Kick-Ass 2,60795985,28795985,32000000,2013,0.4736494523445915,0.5263505476554085
1442,Zoolander,60780981,45172250,15608731,2001,0.7431971195068404,0.2568028804931595
1443,127 Hours,60738797,18335230,42403567,2010,0.301870153931432,0.698129846068568
1444,Taxi 2,60726164,626164,60100000,2000,0.010311272090231156,0.9896887279097688
1445,The Wild Thornberrys,60694737,40108697,20586040,2002,0.660826605114048,0.339173394885952
1446,Why Did I Get Married Too?,60673972,60095852,578120,2010,0.9904716968257822,0.009528303174217769
1447,Evangelion: 3.0 You Can,60488344,174945,60313399,2012,0.002892210109107963,0.997107789890892
1448,21 Grams,60427839,16290476,44137363,2003,0.2695856126842464,0.7304143873157536
1449,The Ghost Writer,60331447,15541549,44789898,2010,0.2576027888076346,0.7423972111923653
1450,My Little Pony: The Movie,60330833,21885107,38445726,2017,0.3627516132588456,0.6372483867411544
1451,Secretariat,60321861,59713955,607906,2010,0.9899222936772458,0.0100777063227542
1452,The Perfect Guy,60273173,57027435,3245738,2015,0.9461495415215655,0.05385045847843451
1453,A Haunted House,60159584,40041683,20117901,2013,0.6655910885288037,0.33440891147119634
1454,The Crimson Rivers,60094966,594966,59500000,2001,0.009900429929521884,0.9900995700704781
1455,Beautiful Creatures,60052138,19452138,40600000,2013,0.323920823601651,0.676079176398349
1456,Morning Glory,60040976,31011732,29029244,2010,0.5165094584738262,0.4834905415261737
1457,Forever Young,59981902,149761,59832141,2015,0.0024967697756566637,0.9975032302243433
1458,Son of the Mask,59981548,17018422,42963126,2005,0.28372762236813226,0.7162723776318677
1459,Keeping the Faith,59945183,37047880,22897303,2000,0.6180293085434404,0.3819706914565596
1460,Adrift,59945012,31445012,28500000,2018,0.5245642790095696,0.47543572099043035
1461,Next Friday,59827328,57328603,2498725,2000,0.9582343874692181,0.04176561253078192
1462,Bombshell,59636523,31762808,27873715,2019,0.5326066377142745,0.4673933622857255
1463,Quartet,59520298,18390117,41130181,2012,0.3089721929819639,0.6910278070180361
1464,The Flintstones in Viva Rock Vegas,59468275,35268275,24200000,2000,0.5930603334298834,0.4069396665701166
1465,Rock of Ages,59418613,38518613,20900000,2012,0.6482583664482373,0.35174163355176263
1466,Miss Granny,59396311,234573,59161738,2015,0.003949285671967069,0.9960507143280329
1467,One Day,59389433,13843771,45545662,2011,0.23310158559688557,0.7668984144031145
1468,Molly's Game,59284015,28780744,30503271,2017,0.48547224745152634,0.5145277525484736
1469,Jeepers Creepers,59217789,37904175,21313614,2001,0.6400808885316539,0.3599191114683461
1470,The Devotion of Suspect X,59035664,686435,58349229,2017,0.011627463019641822,0.9883725369803582
1471,The Gift,58978653,43787265,15191388,2015,0.742425653566554,0.257574346433446
1472,Under the Tuscan Sun,58878723,43610723,15268000,2003,0.7406873107624974,0.25931268923750267
1473,A Walk Among the Tombstones,58834384,26307600,32526784,2014,0.44714668891578774,0.5528533110842122
1474,Shock Wave,58815633,0,58815633,2017,0.0,1.0
1475,Agent Cody Banks,58795814,47938330,10857484,2003,0.8153357652298172,0.1846642347701828
1476,Monster,58469210,34469210,24000000,2003,0.5895275479179555,0.4104724520820445
1477,The Tree of Life,58409247,13303319,45105928,2011,0.22776049484082547,0.7722395051591745
1478,The Ninth Gate,58401898,18661336,39740562,2000,0.31953303983373965,0.6804669601662604
1479,Beginning of the Great Revival,58309289,151000,58158289,2011,0.0025896388481087464,0.9974103611518913
1480,Little Nicky,58292295,39464775,18827520,2000,0.6770152899281114,0.32298471007188856
1481,Must Love Dogs,58231520,43894863,14336657,2005,0.7537990249953976,0.2462009750046023
1482,Huo guo ying xiong,58106427,779818,57326609,2016,0.013420511985705126,0.9865794880142948
1483,L.O.R.D: Legend of Ravaging Dynasties,58089494,350456,57739038,2016,0.0060330358532646195,0.9939669641467354
1484,Doom,58072119,28212337,29859782,2005,0.4858155253470258,0.5141844746529741
1485,Bowling for Columbine,58008423,21576018,36432405,2002,0.3719462947648137,0.6280537052351862
1486,Sky Captain and the World of Tomorrow,57947036,37762677,20184359,2004,0.6516757302306195,0.3483242697693804
1487,Snitch,57824674,42930462,14894212,2013,0.7424246265530179,0.25757537344698217
1488,Dolphin Tale 2,57824533,42024533,15800000,2014,0.7267595745217692,0.27324042547823085
1489,Nine Lives,57814445,19700032,38114413,2016,0.3407458464748732,0.6592541535251268
1490,Heartbreakers,57756408,40336607,17419801,2001,0.6983918909915589,0.3016081090084411
1491,That's My Boy,57719093,36931089,20788004,2012,0.6398418110970663,0.3601581889029337
1492,Cellular,57678321,32003620,25674701,2004,0.5548639323256306,0.44513606767436936
1493,The Motorcycle Diaries,57663224,16781387,40881837,2004,0.2910240849523086,0.7089759150476914
1494,Goldbuster,57628292,186135,57442157,2017,0.0032299239408310073,0.996770076059169
1495,Ready or Not,57615777,28714231,28901546,2019,0.4983744469852416,0.5016255530147584
1496,Drumline,57588485,56399184,1189301,2002,0.9793482846440569,0.02065171535594312
1497,Derailed,57479076,36024076,21455000,2005,0.6267337352465443,0.3732662647534557
1498,Walking Tall,57223890,46437717,10786173,2004,0.8115092664969124,0.18849073350308762
1499,Killer Elite,57084522,25124966,31959556,2011,0.44013622466699465,0.5598637753330054
1500,The 15:17 to Paris,57076286,36276286,20800000,2018,0.6355754472181319,0.36442455278186814
1501,The Descent,57051053,26024456,31026597,2005,0.45616083545381714,0.5438391645461829
1502,All the Money in the World,56996304,25113707,31882597,2017,0.44061992160053043,0.5593800783994696
1503,Elektra,56995646,24409722,32585924,2005,0.4282734509229003,0.5717265490770996
1504,Zoolander 2,56722693,28848693,27874000,2016,0.5085917377018754,0.4914082622981247
1505,Murder by Numbers,56714147,31945749,24768398,2002,0.5632765489711059,0.4367234510288941
1506,Cradle 2 the Grave,56489558,34712347,21777211,2003,0.6144913897184325,0.3855086102815674
1507,The Big Sick,56411585,42873127,13538458,2017,0.7600057151381228,0.2399942848618772
1508,15 Minutes,56359980,24403552,31956428,2001,0.43299433392275866,0.5670056660772413
1509,Frida,56298474,25885000,30413474,2002,0.4597815564237141,0.5402184435762859
1510,Kicking & Screaming,56070433,52842724,3227709,2005,0.9424347409623178,0.05756525903768212
1511,Remember Me,56032889,19068240,36964649,2010,0.3403044237108674,0.6596955762891327
1512,The Odd Life of Timothy Green,56012642,51854875,4157767,2012,0.9257709179295631,0.07422908207043688
1513,Confidential Assignment,55972241,475618,55496623,2017,0.008497390697649572,0.9915026093023505
1514,Dallas Buyers Club,55736588,27298285,28438303,2013,0.4897731630073947,0.5102268369926053
1515,Pay It Forward,55707411,33519628,22187783,2000,0.6017085949300355,0.3982914050699646
1516,All Eyez on Me,55668698,44922302,10746396,2017,0.806958014358446,0.1930419856415539
1517,Cop Out,55611001,44875481,10735520,2010,0.8069533040773713,0.19304669592262869
1518,The Lizzie McGuire Movie,55534455,42734455,12800000,2003,0.7695124585268731,0.23048754147312692
1519,Out of Time,55495563,41088845,14406718,2003,0.7403987414273101,0.25960125857268984
1520,Spanglish,55470154,42726869,12743285,2004,0.7702677191053048,0.2297322808946952
1521,Lawless,55404159,37400127,18004032,2012,0.6750418682467502,0.3249581317532498
1522,Silent Hill: Revelation,55362705,17529157,37833548,2011,0.31662392579986837,0.6833760742001317
1523,Rugrats Go Wild,55250496,39402572,15847924,2003,0.7131623216558997,0.2868376783441003
1524,Extremely Loud & Incredibly Close,55247881,31847881,23400000,2011,0.5764543440136646,0.4235456559863355
1525,The Mothman Prophecies,55157539,35746370,19411169,2002,0.6480776816384066,0.3519223183615933
1526,End of Watch,55078146,41003371,14074775,2012,0.744458083247755,0.2555419167522451
1527,Barbershop: The Next Cut,55030051,54030051,1000000,2016,0.9818281106081476,0.018171889391852464
1528,Downsizing,55003890,24449754,30554136,2017,0.44450954287051336,0.5554904571294866
1529,Analyze That,55003135,32130627,22872508,2002,0.5841599210663174,0.4158400789336826
1530,St. Vincent,54837234,44137712,10699522,2014,0.8048858190039272,0.19511418099607286
1531,The Three Stooges,54819301,44338224,10481077,2012,0.8088068105793614,0.19119318942063854
1532,The Crazies,54806823,39123589,15683234,2010,0.7138452268981181,0.28615477310188187
1533,Driven,54744738,32720065,22024673,2001,0.5976842011738187,0.40231579882618124
1534,The Punisher,54700105,33810189,20889916,2004,0.6181009890200394,0.38189901097996065
1535,Open Water,54683487,30610863,24072624,2004,0.5597825720221536,0.4402174279778464
1536,"Good Night, and Good Luck.",54641191,31558003,23083188,2005,0.5775496914040545,0.4224503085959455
1537,The Hot Chick,54639553,35081594,19557959,2002,0.6420549231067099,0.3579450768932901
1538,Early Man,54622814,8267544,46355270,2018,0.15135697695838227,0.8486430230416178
1539,The Age of Shadows,54491162,541719,53949443,2016,0.009941410315309481,0.9900585896846905
1540,No Escape,54418872,27288872,27130000,2015,0.5014597141962075,0.4985402858037925
1541,No Good Deed,54323210,52543632,1779578,2014,0.9672409270365282,0.03275907296347178
1542,Domestic Disturbance,54249294,45246095,9003199,2001,0.8340402549754841,0.1659597450245159
1543,The Five-Year Engagement,54169363,28835528,25333835,2012,0.5323217110749484,0.4676782889250516
1544,Tyler Perry's Madea's Big Happy Family,54161287,53345287,816000,2011,0.9849338882955274,0.015066111704472605
1545,"I, Tonya",53939297,30014539,23924758,2017,0.5564503185868366,0.4435496814131634
1546,Peppermint,53918723,35418723,18500000,2018,0.6568909838610235,0.34310901613897643
1547,Long Shot,53873809,30316271,23557538,2019,0.5627274470234692,0.4372725529765308
1548,Bounce,53425292,36805288,16620004,2000,0.6889113118932508,0.31108868810674917
1549,Tyler Perry's A Madea Christmas,53396635,52543354,853281,2013,0.9840199480735069,0.01598005192649312
1550,Sinister 2,53329150,27740955,25588195,2015,0.5201837081596088,0.4798162918403912
1551,Æon Flux,53321673,25874337,27447336,2005,0.48524990954428604,0.514750090455714
1552,Little White Lies,53319615,206088,53113527,2010,0.003865144187556493,0.9961348558124435
1553,Radio,53293628,52333738,959890,2003,0.9819886535028165,0.01801134649718349
1554,3 Days to Kill,53260230,30697999,22562231,2014,0.5763775147046868,0.4236224852953132
1555,Pitch Black,53187659,39240659,13947000,2000,0.7377775171492319,0.26222248285076805
1556,Temptation: Confessions of a Marriage Counselor,53143144,51975354,1167790,2013,0.9780255756038823,0.021974424396117777
1557,Delivery Man,53120346,30664106,22456240,2013,0.5772572716299702,0.4227427283700298
1558,Big Fat Liar,52970014,48360547,4609467,2002,0.91297969073597,0.08702030926403002
1559,Pooh's Heffalump Movie,52858433,18098433,34760000,2005,0.34239442928624086,0.6576055707137591
1560,From Paris with Love,52830951,24077427,28753524,2010,0.4557447205521627,0.5442552794478374
1561,Found a Treasure Called Love,52715771,4364639,48351132,2015,0.08279569694617575,0.9172043030538243
1562,Wild,52501541,37880356,14621185,2014,0.7215094124570554,0.2784905875429447
1563,Teo-neol,52444295,568876,51875419,2016,0.010847242774452398,0.9891527572255476
1564,The Boy Next Door,52425855,35423380,17002475,2015,0.6756853083273511,0.3243146916726489
1565,The Night Before,52395996,43047372,9348624,2015,0.8215775113808315,0.17842248861916854
1566,Dragonfly,52323400,30323400,22000000,2002,0.5795380269630797,0.4204619730369204
1567,One Hour Photo,52223306,31597131,20626175,2002,0.6050388881929459,0.3949611118070541
1568,Patriots Day,52185751,31886361,20299390,2016,0.6110166163940038,0.3889833836059962
1569,Elizabethtown,52164016,26850426,25313590,2005,0.51473080600236,0.48526919399764007
1570,The Finest Hours,52099090,27569558,24529532,2016,0.5291754232175648,0.47082457678243517
1571,Teen Titans GO! to the Movies,52090236,29790236,22300000,2018,0.5718967370391641,0.4281032629608359
1572,Detective Dee: Mystery of the Phantom Flame,51899269,459836,51439433,2010,0.008860163329082727,0.9911398366709173
1573,Hanging Up,51880044,36050230,15829814,2000,0.6948766273212875,0.3051233726787125
1574,Blue Crush,51843679,40390647,11453032,2002,0.7790852767219703,0.22091472327802972
1575,Enough,51806184,40007742,11798442,2002,0.7722580377663022,0.2277419622336978
1576,Slender Man,51738549,30569484,21169065,2018,0.5908454061979975,0.4091545938020025
1577,Master,51636415,597251,51039164,2016,0.011566469128424194,0.9884335308715758
1578,Daybreakers,51416464,30101577,21314887,2010,0.5854462687282423,0.4145537312717576
1579,Breaking In,51411620,46840590,4571030,2018,0.9110895552406246,0.08891044475937541
1580,I Spy,51386477,33561137,17825340,2002,0.6531122380699498,0.3468877619300502
1581,Hot Pursuit,51380201,34580201,16800000,2015,0.6730258022929883,0.3269741977070117
1582,Once Upon a Deadpool 2018 Re-release,51247568,6100309,45147259,2018,0.11903606820912946,0.8809639317908705
1583,The 100 Year-Old Man Who Climbed Out the Window and Disappeared,51167572,944193,50223379,2013,0.018452956884489263,0.9815470431155108
1584,Hollywood Homicide,51142659,30940691,20201968,2003,0.6049879221180111,0.3950120778819889
1585,Magic in the Moonlight,51029361,10539326,40490035,2014,0.20653454782629946,0.7934654521737006
1586,Talk to Her 2002 Re-release,51001550,9285469,41716081,2002,0.1820624863361996,0.8179375136638004
1587,Red Dawn,50950296,44806783,6143513,2012,0.8794214463444923,0.12057855365550771
1588,Just Friends,50912434,32619671,18292763,2005,0.6407014640077903,0.3592985359922097
1589,Unleashed,50871113,24537621,26333492,2005,0.4823488135594753,0.5176511864405247
1590,Team America: World Police,50826898,32786074,18040824,2004,0.64505360921298,0.3549463907870199
1591,The Skulls,50802120,35046120,15756000,2000,0.6898554627247839,0.31014453727521607
1592,What a Girl Wants,50732139,36105433,14626706,2003,0.7116875754046168,0.2883124245953832
1593,Diary of a Mad Black Woman,50652203,50633099,19104,2005,0.9996228397015624,0.0003771602984375625
1594,Fever Pitch,50605163,42071069,8534094,2005,0.8313592231685925,0.1686407768314075
1595,War of the Arrows,50587661,251200,50336461,2011,0.004965637766885486,0.9950343622331145
1596,You Got Served,50576805,40363810,10212995,2004,0.7980695894096118,0.20193041059038822
1597,The Himalayas,50544493,696717,49847776,2015,0.013784231647154914,0.9862157683528451
1598,Alpha and Omega,50507267,25107267,25400000,2010,0.49710207048027366,0.5028979295197263
1599,Dragon Ball Z: Battle of Gods,50461371,2553002,47908369,2013,0.05059319533747904,0.9494068046625209
1600,About Last Night,50445860,48637684,1808176,2014,0.9641561071612219,0.03584389283877805
1601,Breakthrough,50444358,40713082,9731276,2019,0.8070889117074302,0.1929110882925698
1602,Just Mercy,50401502,36001502,14400000,2019,0.7142942287711981,0.28570577122880186
1603,Red Tails,50365498,49876377,489121,2012,0.9902885701636466,0.009711429836353449
1604,"Monsters, Inc. 2012 3D Release",50207820,34043006,16164814,2012,0.6780419066193274,0.32195809338067255
1605,The Closet,50104745,6678894,43425851,2001,0.13329863269436856,0.8667013673056314
1606,National Security,50097949,36381186,13716763,2003,0.7262011065562783,0.2737988934437216
1607,The Replacements,50054511,44737059,5317452,2000,0.8937667775837427,0.10623322241625735
1608,Uncut Gems,50023780,50023780,0,2019,1.0,0.0
1609,21 Bridges,49939757,28539757,21400000,2019,0.5714836978481894,0.42851630215181064
1610,Winnie the Pooh,49871429,26692846,23178583,2011,0.535233229430823,0.464766770569177
1611,The Wailing,49851770,786633,49065137,2016,0.015779439727014708,0.9842205602729853
1612,The Switch,49830607,27779426,22051181,2010,0.5574771746208108,0.44252282537918913
1613,She's Out of My League,49779728,32010860,17768868,2010,0.6430501187149917,0.3569498812850082
1614,Raising Helen,49718611,37486512,12232099,2004,0.7539734366271817,0.24602656337281828
1615,The Boy and the Beast,49714378,490643,49223735,2015,0.009869237426645467,0.9901307625733545
1616,Surprise,49567466,0,49567466,2015,0.0,1.0
1617,Death Wish,49562710,34017028,15545682,2018,0.6863431801852643,0.3136568198147357
1618,The Grudge,49511319,21221803,28289516,2020,0.4286252806151256,0.5713747193848744
1619,Andhadhun,49391206,1193046,48198160,2018,0.024155028731227983,0.975844971268772
1620,Capote,49327405,28750530,20576875,2005,0.5828510540945748,0.4171489459054252
1621,Entourage,49263404,32363404,16900000,2015,0.6569461582476112,0.34305384175238884
1622,Death at a Funeral,49050886,42739347,6311539,2010,0.8713267075338863,0.12867329246611367
1623,Little,48987096,40860481,8126615,2019,0.8341070268790786,0.16589297312092147
1624,Whiplash,48982041,13092000,35890041,2014,0.2672816349159481,0.732718365084052
1625,So Young 2: Never Gone,48980792,96421,48884371,2016,0.0019685471806989156,0.9980314528193011
1626,The Berlin File,48972848,665210,48307638,2013,0.013583241064518036,0.986416758935482
1627,Trouble with the Curve,48963137,35763137,13200000,2012,0.7304094302617906,0.2695905697382094
1628,Luck-Key,48913975,466505,48447470,2016,0.00953725392385305,0.9904627460761469
1629,Florence Foster Jenkins,48902953,27383770,21519183,2016,0.559961481262696,0.44003851873730404
1630,The Woman in Black 2: Angel of Death,48854305,26501323,22352982,2015,0.5424562482262311,0.457543751773769
1631,Isn't It Romantic,48791187,48791187,0,2019,1.0,0.0
1632,Mother's Day,48782670,32492859,16289811,2016,0.6660738126879894,0.33392618731201057
1633,How Do You Know,48668907,30212620,18456287,2010,0.6207786831950017,0.3792213168049983
1634,Concussion,48623572,34542474,14081098,2015,0.7104059323325732,0.28959406766742685
1635,Fat Albert,48551322,48116322,435000,2004,0.9910404087452037,0.008959591254796317
1636,Her,48517427,25568251,22949176,2013,0.5269910747740189,0.47300892522598115
1637,Logan Lucky,48453605,27780977,20672628,2017,0.5733521169374292,0.4266478830625709
1638,Homefront,48449416,20158898,28290518,2013,0.4160813414138986,0.5839186585861015
1639,Chef,48428048,31424003,17004045,2014,0.6488802315550691,0.3511197684449309
1640,Boo 2! A Madea Halloween,48333932,47319572,1014360,2017,0.979013501322425,0.020986498677575
1641,The Last Stand,48330757,12050299,36280458,2013,0.24932982117370933,0.7506701788262907
1642,Secondhand Lions,48249017,42070939,6178078,2003,0.8719543239606311,0.12804567603936884
1643,Charlie St. Cloud,48190704,31162545,17028159,2010,0.6466505448851713,0.3533494551148288
1644,Arthur,48147945,33035397,15112548,2011,0.6861226787560715,0.3138773212439285
1645,Boyhood,48137666,25352281,22785385,2014,0.5266620321807874,0.4733379678192125
1646,21 & Over,48065672,25682380,22383292,2013,0.5343185465086184,0.4656814534913815
1647,Countdown,48021766,25621766,22400000,2019,0.5335448513076341,0.4664551486923659
1648,"Yo-kai Watch Movie: It's the Secret of Birth, Meow! 2016 Re-release",47899805,257343,47642462,2016,0.005372527090663521,0.9946274729093365
1649,Midsommar,47863365,27426361,20437004,2019,0.5730136399728686,0.4269863600271314
1650,Phantom Thread,47756590,21198205,26558385,2017,0.4438802058522185,0.5561197941477815
1651,Book of Shadows: Blair Witch 2,47737094,26437094,21300000,2000,0.5538061030694496,0.4461938969305505
1652,Scott Pilgrim vs. the World,47664559,31524275,16140284,2010,0.6613776705665104,0.3386223294334896
1653,Man on a Ledge,47636031,18620000,29016031,2012,0.3908805920459662,0.6091194079540337
1654,Queen & Slim,47595818,43808310,3787508,2019,0.9204235128388801,0.07957648716111991
1655,Coming Home,47587984,377607,47210377,2014,0.007934923236084135,0.9920650767639159
1656,A Walk to Remember,47494916,41281092,6213824,2002,0.8691686495455639,0.130831350454436
1657,Darkness Falls,47488536,32551396,14937140,2003,0.685457980848262,0.314542019151738
1658,Beauty and the Beast,47430624,0,47430624,2014,0.0,1.0
1659,Nightcrawler,47398992,32381217,15017775,2014,0.683162565988745,0.3168374340112549
1660,Almost Famous,47383689,32534850,14848839,2000,0.6866255179076496,0.31337448209235036
1661,Rough Night,47347283,22105643,25241640,2017,0.466883031070653,0.533116968929347
1662,Texas Chainsaw,47340586,34341945,12998641,2013,0.7254228961170865,0.2745771038829135
1663,Broken Flowers,47329961,13744960,33585001,2005,0.29040716936149596,0.709592830638504
1664,Fantasy Island,47315959,26441782,20874177,2020,0.5588343247993769,0.4411656752006231
1665,A Monster Calls,47309313,3740823,43568490,2016,0.07907159843982516,0.9209284015601749
1666,Tiny Times 2.0,47289937,43788,47246149,2013,0.0009259475224084143,0.9990740524775916
1667,Golden Job,47287337,285795,47001542,2018,0.006043795614880999,0.993956204385119
1668,Mortdecai,47275695,7696134,39579561,2015,0.16279261468287246,0.8372073853171276
1669,The Watcher,47267829,28946615,18321214,2000,0.612395695177792,0.3876043048222079
1670,High Fidelity,47126295,27287137,19839158,2000,0.5790214783487647,0.4209785216512353
1671,Soul Surfer,47120948,43853424,3267524,2011,0.9306566582658736,0.0693433417341264
1672,The Wedding Date,47096206,31726995,15369211,2005,0.6736635006225342,0.3263364993774658
1673,Land of the Dead,47074133,20700082,26374051,2005,0.4397336855890686,0.5602663144109313
1674,Dracula 2000,47053625,33022767,14030858,2000,0.7018113269700262,0.29818867302997376
1675,The Place Beyond the Pines,47052899,21403519,25649380,2013,0.45488204669387106,0.5451179533061289
1676,Son of Bigfoot,47046281,289308,46756973,2017,0.006149434000957483,0.9938505659990425
1677,Parker,46922566,17616641,29305925,2013,0.3754406994706982,0.6245593005293019
1678,47 Meters Down: Uncaged,46783103,22260900,24522203,2019,0.47583205414997803,0.5241679458500219
1679,Mary Queen of Scots,46710283,16468499,30241784,2018,0.352566885539957,0.647433114460043
1680,Uncle Drew,46664414,42469946,4194468,2018,0.9101142039413588,0.08988579605864118
1681,Get Rich or Die Tryin',46563961,30985352,15578609,2005,0.6654363446443055,0.3345636553556945
1682,Torque,46546197,21215059,25331138,2003,0.45578501289804624,0.5442149871019538
1683,The Big Wedding,46522137,21819348,24702789,2013,0.4690100112984922,0.5309899887015078
1684,Risen,46432579,36880033,9552546,2016,0.7942706133122608,0.20572938668773924
1685,Tyler Perry's Acrimony,46403669,43549096,2854573,2018,0.9384838944523978,0.061516105547602284
1686,A Werewolf Boy,46282588,342922,45939666,2012,0.007409309090494248,0.9925906909095058
1687,The Thousand Faces of Dunjia,46263237,124187,46139050,2017,0.002684356047113608,0.9973156439528864
1688,Asterix: The Secret of the Magic Potion,46221204,1271953,44949251,2018,0.027518820150163114,0.9724811798498368
1689,The Fog,46201432,29550869,16650563,2005,0.6396093740124765,0.3603906259875235
1690,The Battleship Island,46183383,1104957,45078426,2017,0.023925423566307388,0.9760745764336927
1691,Eddie the Eagle,46152800,15789389,30363411,2016,0.342111182853478,0.657888817146522
1692,Napoleon Dynamite,46118097,44540956,1577141,2004,0.9658021231882139,0.03419787681178606
1693,Into the Blue,46117696,18801234,27316462,2005,0.4076793862382024,0.5923206137617977
1694,The World's End,46089287,26004851,20084436,2013,0.5642276696534707,0.43577233034652935
1695,The Hunted,46061847,34244097,11817750,2003,0.7434373398009854,0.2565626601990146
1696,Let's Get Married,45972724,462918,45509806,2015,0.010069405502271303,0.9899305944977287
1697,Eight Legged Freaks,45867333,17322606,28544727,2002,0.37766760932012333,0.6223323906798767
1698,Avatar 2010 Special Edition,45823494,10741486,35082008,2010,0.23441001683546872,0.7655899831645313
1699,Somewhere Only We Know,45737711,482341,45255370,2015,0.010545805407708313,0.9894541945922917
1700,Chasing the Dragon II: Wild Wild Bunch,45733356,196634,45536722,2019,0.004299575128490461,0.9957004248715096
1701,"McFarland, USA",45710059,44482410,1227649,2015,0.9731426949153577,0.026857305084642312
1702,Earth to Echo,45681062,38934842,6746220,2014,0.8523191076424624,0.14768089235753756
1703,That Awkward Moment,45640143,26068955,19571188,2014,0.5711847791537376,0.42881522084626245
1704,The Debt,45636368,31177548,14458820,2011,0.6831732972264576,0.31682670277354236
1705,Hero,45565534,88675,45476859,2015,0.0019460981188105905,0.9980539018811894
1706,Machete,45491656,26593646,18898010,2010,0.5845829397813085,0.4154170602186915
1707,Queen of the Damned,45479110,30336800,15142310,2002,0.6670491133181806,0.33295088668181944
1708,Wei ai zhi jian ru jia jing,45386560,271734,45114826,2014,0.005987102789900799,0.9940128972100992
1709,Good Boy,45312217,37667746,7644471,2003,0.8312933794433408,0.16870662055665914
1710,Blair Witch,45173154,20777061,24396093,2016,0.4599426686035693,0.5400573313964308
1711,Flatliners,45158254,16883115,28275139,2017,0.3738655396198445,0.6261344603801555
1712,Deuce Bigalow: European Gigolo,45109561,22400154,22709407,2005,0.49657220117925777,0.5034277988207423
1713,Monster's Ball,44909486,31273922,13635564,2001,0.6963767521186949,0.30362324788130507
1714,Grudge Match,44907260,29807260,15100000,2013,0.6637514735924659,0.3362485264075341
1715,Child's Play,44902237,29208403,15693834,2019,0.6504888164035124,0.34951118359648764
1716,Still Alice,44779195,18754371,26024824,2015,0.41881885103115407,0.5811811489688459
1717,The Man from Nowhere,44723232,528175,44195057,2010,0.011809857570222116,0.9881901424297779
1718,Hellboy,44664690,21903748,22760942,2019,0.4904041201226293,0.5095958798773706
1719,Uptown Girls,44617342,37182494,7434848,2003,0.8333641658886807,0.16663583411131933
1720,The Gift,44567606,12008642,32558964,2000,0.2694477688570483,0.7305522311429516
1721,Mother!,44516999,17800004,26716995,2017,0.3998473482006278,0.6001526517993722
1722,Recess: School's Out,44460850,36706141,7754709,2001,0.8255834290167642,0.17441657098323582
1723,Oculus,44446287,27695246,16751041,2014,0.6231172021185931,0.37688279788140683
1724,A Man Apart,44350926,26736098,17614828,2003,0.6028306601760693,0.3971693398239306
1725,Dark Water 2005 Re-release,44347079,25473352,18873727,2005,0.5744087902610227,0.4255912097389774
1726,House at the End of the Street,44287131,31611916,12675215,2012,0.7137946235442526,0.2862053764557474
1727,Hardball,44102389,40222729,3879660,2001,0.912030615847137,0.08796938415286301
1728,Winchester,44019588,25091816,18927772,2018,0.5700147852360635,0.4299852147639365
1729,Wind River,43980821,33800859,10179962,2017,0.7685363354176585,0.23146366458234147
1730,Max,43967255,42656255,1311000,2015,0.9701823550276223,0.029817644972377738
1731,Timeline,43935763,19481943,24453820,2003,0.4434187930228957,0.5565812069771042
1732,The Transporter,43928932,25296447,18632485,2002,0.5758493514023969,0.42415064859760304
1733,Battle of Memories,43892362,594552,43297810,2017,0.01354568250393998,0.98645431749606
1734,Of Gods and Men,43803417,3951596,39851821,2010,0.09021204898238874,0.9097879510176112
1735,Café Society,43763247,11103205,32660042,2016,0.25371072215002693,0.746289277849973
1736,Richard Jewell,43745542,22345542,21400000,2019,0.5108072955182497,0.4891927044817504
1737,The DUFF,43709744,34030343,9679401,2015,0.7785527867653491,0.22144721323465083
1738,The Sea Inside,43685449,2104923,41580526,2004,0.04818361830274424,0.9518163816972558
1739,Judy,43613708,24313888,19299820,2019,0.5574827070424739,0.4425172929575261
1740,Boy,43551154,256211,43294943,2010,0.005882989920313018,0.994117010079687
1741,League of Gods,43498766,181633,43317133,2016,0.004175589716728976,0.9958244102832711
1742,The Master of Disguise,43411001,40388794,3022207,2002,0.9303815408449116,0.06961845915508837
1743,In the Bedroom,43368779,35930604,7438175,2001,0.8284900988335411,0.17150990116645895
1744,Orange County,43325009,41076018,2248991,2002,0.94809023582661,0.051909764173390015
1745,Harriet,43282155,43082155,200000,2019,0.9953791579924798,0.004620842007520189
1746,Beastly,43202283,27865571,15336712,2011,0.6450022791619601,0.35499772083804
1747,The Snowman,43155261,6700035,36455226,2017,0.1552541878961177,0.8447458121038823
1748,Annihilation,43070915,32732301,10338614,2018,0.7599629819798349,0.2400370180201651
1749,See Spot Run,43057552,33357476,9700076,2001,0.7747183583497733,0.22528164165022665
1750,When in Rome,43053376,32680633,10372743,2010,0.7590724824924299,0.24092751750757013
1751,Gifted,43046590,24801212,18245378,2017,0.5761481223019059,0.42385187769809407
1752,The Possession of Hannah Grace,43016528,14837422,28179106,2018,0.3449237465190124,0.6550762534809876
1753,Legend,42972994,1872994,41100000,2015,0.04358537364187378,0.9564146263581262
1754,The Gallows,42964410,22764410,20200000,2015,0.5298434215668271,0.47015657843317293
1755,A Lot Like Love,42886719,21845719,21041000,2005,0.5093819137808141,0.49061808621918596
1756,Basic,42792561,26793311,15999250,2003,0.6261207643076094,0.37387923569239057
1757,Shaolin Soccer,42776760,489600,42287160,2001,0.01144546711812676,0.9885545328818732
1758,Shaolin,42741494,66099,42675395,2011,0.001546483143523247,0.9984535168564768
1759,Almost Christmas,42580920,42158780,422140,2016,0.9900861700498721,0.009913829950127897
1760,Oliver Twist,42580321,2080321,40500000,2005,0.04885639542266485,0.9511436045773352
1761,Love the Coopers,42426912,26302731,16124181,2015,0.6199539339558816,0.3800460660441184
1762,8 Women,42426583,3098776,39327807,2002,0.0730385475540182,0.9269614524459818
1763,My Name Is Khan,42345360,4018771,38326589,2010,0.09490463654105195,0.905095363458948
1764,Loving Vincent,42187665,6735118,35452547,2017,0.15964661708582353,0.8403533829141765
1765,Long Day's Journey Into Night,42140994,521365,41619629,2018,0.01237191984602926,0.9876280801539707
1766,Jobs,42128352,16131410,25996942,2013,0.3829110144161348,0.6170889855838653
1767,Going the Distance,42059111,17804299,24254812,2010,0.4233161038520286,0.5766838961479713
1768,Bang Bang,42045981,2546172,39499809,2014,0.060556846087144456,0.9394431539128556
1769,The Sisterhood of the Traveling Pants,42013878,39053061,2960817,2005,0.9295276432230322,0.07047235677696784
1770,Mary and the Witch's Flower,41978431,2418404,39560027,2017,0.05761063342267366,0.9423893665773263
1771,"As Above, So Below",41898409,21321100,20577309,2014,0.5088761246280259,0.49112387537197416
1772,Call Me by Your Name,41887595,18095701,23791894,2017,0.4320062061333433,0.5679937938666567
1773,The Guilt Trip,41863726,37134215,4729511,2012,0.8870260377683534,0.11297396223164656
1774,Wimbledon,41682237,17001133,24681104,2004,0.4078747740914193,0.5921252259085806
1775,T2 Trainspotting,41681746,2402004,39279742,2017,0.05762724047116452,0.9423727595288355
1776,Overlord,41657844,21704844,19953000,2018,0.5210265802522089,0.47897341974779106
1777,Born to Be Wild,41644475,25978556,15665919,2011,0.6238175892480335,0.3761824107519665
1778,Undercover Brother,41604473,39089928,2514545,2002,0.9395607054078056,0.06043929459219445
1779,Safe,41564670,17142080,24422590,2012,0.4124194899177595,0.5875805100822405
1780,The Great Battle,41509280,472166,41037114,2018,0.0113749503725432,0.9886250496274568
1781,The Lady in the Van,41387687,10021175,31366512,2015,0.24212938017048405,0.757870619829516
1782,Shark Night 3D,41363927,18877153,22486774,2011,0.45636752525938845,0.5436324747406115
1783,Ricki and the Flash,41325328,26822144,14503184,2015,0.6490485447568619,0.35095145524313803
1784,Pinocchio,41314585,3675719,37638866,2002,0.08896904083630515,0.9110309591636948
1785,This Is Where I Leave You,41296320,34296320,7000000,2014,0.8304933708378858,0.1695066291621142
1786,The Darkest Minds,41142379,12695691,28446688,2018,0.30857940908084097,0.6914205909191591
1787,50/50,41097853,35014192,6083661,2011,0.8519713183070659,0.14802868169293418
1788,Fist Fight,41087017,32187017,8900000,2017,0.7833865622320549,0.21661343776794503
1789,Whale Rider,41062976,20779666,20283310,2003,0.5060438386151067,0.4939561613848933
1790,Dredd,41037742,13414714,27623028,2012,0.32688723468264896,0.6731127653173511
1791,Fright Night,41002607,18302607,22700000,2011,0.4463766657568871,0.5536233342431128
1792,Twisted,40954603,25198598,15756005,2004,0.6152812175959806,0.3847187824040194
1793,Drive Angry,40909909,10721033,30188876,2011,0.262064454848824,0.737935545151176
1794,The Intruder,40887246,35419122,5468124,2019,0.8662633330696814,0.13373666693031858
1795,Underwater,40882928,17291078,23591850,2020,0.4229412824834855,0.5770587175165145
1796,Where the Heart Is,40863718,33772838,7090880,2000,0.8264749184105078,0.17352508158949217
1797,Fighting with My Family,40810036,22958886,17851150,2019,0.562579410613605,0.43742058938639505
1798,30 Minutes or Less,40662632,37053924,3608708,2011,0.9112524737700206,0.0887475262299794
1799,The Circle,40656399,20497844,20158555,2017,0.504172639588666,0.495827360411334
1800,The Roommate,40492652,37300000,3192652,2011,0.9211547813662587,0.07884521863374125
1801,Holmes & Watson,40466970,30573626,9893344,2018,0.7555205146320567,0.24447948536794328
1802,Serenity,40445129,25514517,14930612,2005,0.6308427647739732,0.36915723522602684
1803,Bless the Child,40443010,29381494,11061516,2000,0.7264912774790996,0.2735087225209004
1804,The Ringer,40442443,35428675,5013768,2005,0.8760270738342884,0.12397292616571161
1805,The Witch,40423945,25138705,15285240,2016,0.6218765882449128,0.37812341175508724
1806,The Art of War,40400425,30208599,10191826,2000,0.7477297330411747,0.2522702669588253
1807,Bad Education,40350837,5211842,35138995,2004,0.12916316952731366,0.8708368304726863
1808,Magnificent Desolation: Walking on the Moon 3D,40339402,34137524,6201878,2005,0.8462575622712504,0.15374243772874968
1809,Carol,40272135,12711491,27560644,2015,0.3156398586764769,0.6843601413235231
1810,Crimson Rivers 2: Angels of the Apocalypse,40152148,152148,40000000,2004,0.0037892866902164237,0.9962107133097836
1811,Diary of a Wimpy Kid: The Long Haul,40140972,20738724,19402248,2017,0.5166472799911273,0.48335272000887275
1812,The Wild Life,40075446,8005586,32069860,2016,0.19976286726790266,0.8002371327320974
1813,Northern Limit Line,40034677,337907,39696770,2015,0.008440357842777151,0.9915596421572228
1814,Dancer in the Dark,40031879,4184036,35847843,2000,0.10451760208407904,0.895482397915921
1815,Dream House,39984400,21302340,18682060,2011,0.532766278848751,0.467233721151249
1816,Black Knight,39976235,33426971,6549264,2001,0.8361710651340728,0.16382893486592723
1817,Brotherhood of Blades 2,39966092,14204,39951888,2017,0.0003554012736596813,0.9996445987263404
1818,Monte Carlo,39782683,23186769,16595914,2011,0.5828357277964384,0.41716427220356156
1819,Memento,39723096,25544867,14178229,2001,0.6430734150228371,0.3569265849771629
1820,The Forest,39712000,26594261,13117739,2016,0.6696782080983078,0.3303217919016922
1821,The November Man,39661919,25018119,14643800,2014,0.6307843803523475,0.3692156196476524
1822,Down with Love,39468111,20305251,19162860,2003,0.5144723293192319,0.4855276706807681
1823,The Legend of Bagger Vance,39459427,30919168,8540259,2000,0.7835686007300613,0.2164313992699387
1824,Don Jon,39439355,24477704,14961651,2013,0.6206415901071405,0.37935840989285957
1825,Crocodile Dundee in Los Angeles,39438674,25635682,13802992,2001,0.6500137910316153,0.34998620896838467
1826,Frank Miller's Sin City: A Dame to Kill For,39407616,13757804,25649812,2014,0.3491153588179503,0.6508846411820497
1827,The Gambler,39280992,33680992,5600000,2014,0.8574374089126874,0.14256259108731267
1828,Dumb and Dumberer: When Harry Met Lloyd,39267515,26276465,12991050,2003,0.6691654666713694,0.33083453332863055
1829,Mars Needs Moms,39233678,21392758,17840920,2011,0.5452651673391417,0.45473483266085835
1830,Absolutely Fabulous: The Movie,39219109,4772155,34446954,2016,0.12167933238870877,0.8783206676112912
1831,Samba,39178695,151530,39027165,2014,0.0038676632797493638,0.9961323367202506
1832,Show Dogs,39156854,17857020,21299834,2018,0.4560381689499366,0.5439618310500635
1833,Women Who Flirt,39156132,375495,38780637,2014,0.009589685722787941,0.990410314277212
1834,Haunted Castle,39093166,13651656,25441510,2001,0.3492082478047442,0.6507917521952559
1835,Believer,39047153,365639,38681514,2018,0.009364037372968011,0.990635962627032
1836,The Life of David Gale,38955598,19955598,19000000,2003,0.512265220521066,0.48773477947893396
1837,The Spy Gone North,38844509,500803,38343706,2018,0.012892504317663018,0.987107495682337
1838,Criminal,38803993,14708696,24095297,2015,0.3790510940459143,0.6209489059540857
1839,Clockstoppers,38793283,36989956,1803327,2002,0.9535144524891075,0.046485547510892546
1840,Dreamer: Inspired by a True Story,38741732,32751093,5990639,2005,0.8453698714347618,0.15463012856523814
1841,Someone Like You,38689940,27343067,11346873,2001,0.7067229103999645,0.29327708960003557
1842,On the Basis of Sex,38673750,24622687,14051063,2018,0.6366769966708685,0.36332300332913153
1843,"Crouching Tiger, Hidden Dragon: Sword of Destiny",38659039,0,38659039,2016,0.0,1.0
1844,Head of State,38620484,38125247,495237,2003,0.987176830823767,0.012823169176233006
1845,The Best of Me,38609668,26766213,11843455,2014,0.6932515710831805,0.30674842891681947
1846,Urban Legends: Final Cut,38574362,21468807,17105555,2000,0.5565563728571843,0.44344362714281577
1847,Million Dollar Arm,38483455,36457627,2025828,2014,0.9473584687237672,0.05264153127623286
1848,What's the Worst That Could Happen?,38464131,32269834,6194297,2001,0.8389591331206728,0.16104086687932714
1849,Chernobyl Diaries,38390020,18119640,20270380,2012,0.4719882927906784,0.5280117072093216
1850,The Missing,38364277,27011180,11353097,2003,0.7040711336746943,0.2959288663253057
1851,Boruto: Naruto The Movie,38362448,919651,37442797,2015,0.023972688082887723,0.9760273119171122
1852,The Lazarus Effect,38356892,25801570,12555322,2015,0.6726710287162996,0.3273289712837005
1853,Van Wilder: Party Liaison,38275483,21305259,16970224,2002,0.5566293964206801,0.44337060357931996
1854,Don't Be Afraid of the Dark,38269529,24046682,14222847,2011,0.6283506128335157,0.3716493871664843
1855,The Original Kings of Comedy,38182790,38182790,0,2000,1.0,0.0
1856,The Water Diviner,38176317,4196641,33979676,2014,0.10992786444014492,0.8900721355598551
1857,Jumping the Broom,38158601,37295394,863207,2011,0.9773784421499101,0.022621557850089943
1858,One for the Money,38080789,26414527,11666262,2011,0.6936444252770078,0.30635557472299224
1859,The Producers,38075318,19398532,18676786,2005,0.5094778722530958,0.4905221277469042
1860,The Banger Sisters,38068353,30307416,7760937,2002,0.7961315268879638,0.20386847311203612
1861,But Always,38039248,430760,37608488,2014,0.011324093473141214,0.9886759065268588
1862,Overcomer,38026103,34746945,3279158,2019,0.9137656046426845,0.08623439535731547
1863,The Eagle,37989684,19490041,18499643,2011,0.5130350913158425,0.48696490868415754
1864,For Colored Girls,37981984,37729698,252286,2010,0.9933577456090761,0.0066422543909238655
1865,Killing Them Softly,37930465,15026056,22904409,2012,0.39614742397700636,0.6038525760229937
1866,Hell or High Water,37879877,27007844,10872033,2016,0.7129865812394269,0.28701341876057307
1867,Bulletproof Monk,37713879,23358708,14355171,2003,0.6193663611213261,0.3806336388786738
1868,The Handmaiden,37692886,2006788,35686098,2016,0.05324049742436809,0.9467595025756319
1869,Casanova,37691644,11304403,26387241,2005,0.2999180136584119,0.700081986341588
1870,The Prince and Me,37666766,28176497,9490269,2004,0.7480466201956387,0.2519533798043612
1871,Halloween: Resurrection,37664855,30354442,7310413,2002,0.8059089036716058,0.1940910963283942
1872,Pokémon the Movie: I Choose You!,37552144,2401722,35150422,2017,0.06395698738266449,0.9360430126173355
1873,A Walk in the Woods,37461274,29504281,7956993,2015,0.7875941699153104,0.21240583008468958
1874,Snowden,37357216,21587519,15769697,2016,0.5778674460109662,0.4221325539890339
1875,The Majestic,37317558,27807266,9510292,2001,0.7451523489291555,0.25484765107084445
1876,Home Again,37270721,27020284,10250437,2017,0.7249734718037786,0.27502652819622136
1877,Beauty Shop,37245453,36351350,894103,2005,0.9759943045933688,0.024005695406631247
1878,"Like Father, Like Son",37170163,334616,36835547,2013,0.009002274216553745,0.9909977257834462
1879,Pain and Glory,37137074,4567338,32569736,2019,0.12298594121874007,0.8770140587812599
1880,Till The End Of The World,37013733,118660,36895073,2018,0.003205837141582018,0.9967941628584179
1881,Devil's Due,36921560,15821461,21100099,2014,0.42851550692874296,0.571484493071257
1882,Ex Machina,36869414,25442958,11426456,2015,0.6900830590906598,0.3099169409093402
1883,The Adventurers,36796816,216556,36580260,2017,0.0058851831093211975,0.9941148168906788
1884,Titan A.E.,36754634,22753426,14001208,2000,0.6190627826684385,0.3809372173315615
1885,Valentine,36684136,20384136,16300000,2001,0.5556662422143457,0.44433375778565426
1886,Joy Ride,36642838,21974919,14667919,2001,0.5997057051094132,0.4002942948905868
1887,Return to Me,36609995,32722798,3887197,2000,0.8938214277275919,0.10617857227240812
1888,Burnt,36606743,13651946,22954797,2015,0.3729352813496683,0.6270647186503318
1889,The Priests,36577134,185093,36392041,2015,0.005060347265042691,0.9949396527349573
1890,Furry Vengeance,36288132,17630465,18657667,2010,0.48584658477322556,0.5141534152267744
1891,A Most Wanted Man,36233517,17237855,18995662,2014,0.4757433566275115,0.5242566433724886
1892,A Very Harold & Kumar Christmas,36192775,35061031,1131744,2011,0.9687301125708101,0.031269887429189944
1893,Nothing to Lose,36075317,1016188,35059129,2018,0.028168512005036575,0.9718314879949634
1894,Kundo: Age of the Rampant,35941291,280958,35660333,2014,0.00781713711953196,0.9921828628804681
1895,Ra.One,35911689,2511689,33400000,2011,0.06994070927713815,0.9300592907228619
1896,You Will Meet a Tall Dark Stranger,35867322,3248246,32619076,2010,0.09056282484652743,0.9094371751534726
1897,Garden State,35825316,26782316,9043000,2004,0.747580733132961,0.2524192668670389
1898,Conquest 1453,35797045,35730,35761315,2012,0.0009981270800425008,0.9990018729199575
1899,Riding in Cars with Boys,35743308,30165536,5577772,2001,0.8439491946296632,0.15605080537033675
1900,Tad the Lost Explorer and the Secret of King Midas,35704046,5874,35698172,2017,0.00016451916962016014,0.9998354808303799
1901,Hostiles,35669017,29819114,5849903,2017,0.835994835517895,0.164005164482105
1902,Faster,35626958,23240020,12386938,2010,0.6523155864163311,0.34768441358366886
1903,Tyler Perry's Good Deeds,35579177,35025791,553386,2012,0.9844463518647438,0.015553648135256191
1904,My Dog Skip,35547761,34134641,1413120,2000,0.9602472853353549,0.039752714664645125
1905,Jersey Girl,35492921,25268157,10224764,2004,0.7119210334928477,0.28807896650715226
1906,Mia and the White Lion,35487190,399471,35087719,2018,0.011256766173934877,0.9887432338260651
1907,Arbitrage,35485056,7919574,27565482,2012,0.22318054112694652,0.7768194588730535
1908,Original Sin,35402320,16534221,18868099,2001,0.46703778170470184,0.5329622182952981
1909,Room,35401758,14677654,20724104,2015,0.4146024047732319,0.5853975952267682
1910,Namiya,35351623,70814,35280809,2017,0.0020031329254670996,0.997996867074533
1911,Assault on Precinct 13,35294470,20040895,15253575,2005,0.5678196896000989,0.4321803103999012
1912,Eye in the Sky,35259653,18704595,16555058,2016,0.5304815393390286,0.46951846066097136
1913,Courageous,35185884,34522221,663663,2011,0.9811383735591239,0.01886162644087612
1914,The Girl in the Spider's Web,35164920,14841338,20323582,2018,0.42204953118050603,0.577950468819494
1915,The Adventures of Rocky & Bullwinkle,35134820,26005820,9129000,2000,0.7401722849298786,0.2598277150701213
1916,Alfie,35060882,13399812,21661070,2004,0.3821869626668262,0.6178130373331737
1917,My Week with Marilyn,35057696,14600347,20457349,2011,0.4164662446727817,0.5835337553272183
1918,Flight of the Phoenix,35021497,21009180,14012317,2004,0.5998938309233326,0.4001061690766674
1919,When Marnie Was There,34949567,561085,34388482,2014,0.016054133088401354,0.9839458669115987
1920,The Sitter,34942188,30441326,4500862,2011,0.8711911801287315,0.12880881987126852
1921,The Hate U Give,34934009,29719483,5214526,2018,0.8507321046376326,0.14926789536236737
1922,Lost and Love,34930177,188817,34741360,2015,0.005405555202311171,0.9945944447976889
1923,Secret in Their Eyes,34854990,20180155,14674835,2015,0.578974631752871,0.42102536824712905
1924,Chimpanzee,34823764,28972764,5851000,2012,0.8319825507661952,0.16801744923380482
1925,Kidnap,34814102,30971040,3843062,2017,0.8896119164584513,0.11038808354154876
1926,The Life Aquatic with Steve Zissou,34808403,24020403,10788000,2004,0.6900748362399735,0.30992516376002655
1927,Broken City,34737199,19701164,15036035,2013,0.5671488941868917,0.4328511058131083
1928,Endless Love,34718173,23438250,11279923,2014,0.6751003285800782,0.32489967141992177
1929,Jane Eyre,34710627,11242660,23467967,2011,0.3238967708650149,0.6761032291349851
1930,The Kids Are All Right,34705850,20811365,13894485,2010,0.5996500589958177,0.4003499410041823
1931,Malibu's Most Wanted,34622504,34432201,190303,2003,0.9945034882514563,0.005496511748543664
1932,Alex Cross,34618867,25888412,8730455,2012,0.7478122262060165,0.2521877737939835
1933,Salmon Fishing in the Yemen,34564651,9047981,25516670,2012,0.2617697774526929,0.7382302225473071
1934,Haywire,34513760,18942396,15571364,2012,0.548836058430029,0.4511639415699709
1935,Steve Jobs,34441873,17766658,16675215,2015,0.515844710303647,0.484155289696353
1936,Swimfan,34411240,28564995,5846245,2002,0.8301065291457094,0.16989347085429063
1937,The Medallion,34268701,22219192,12049509,2003,0.648381507078427,0.35161849292157293
1938,American Psycho,34266564,15070285,19196279,2000,0.43979562701413544,0.5602043729858646
1939,Wild Safari - A South African Adventure,34257135,16621530,17635605,2005,0.48519906874874386,0.5148009312512561
1940,Bad News Bears,34252847,32868349,1384498,2005,0.95958006060051,0.040419939399489915
1941,Victor Frankenstein,34227298,5775076,28452222,2015,0.16872719546836562,0.8312728045316343
1942,The House,34184504,25584504,8600000,2017,0.748424022767743,0.25157597723225705
1943,Cirque du Soleil: Worlds Away,34153101,12512862,21640239,2012,0.36637557450493297,0.633624425495067
1944,The Bad Guys: The Movie,34024386,166972,33857414,2019,0.004907421400638942,0.9950925785993611
1945,Darkness,33988736,22163442,11825294,2002,0.6520819720980504,0.34791802790194964
1946,Dungeons & Dragons,33978694,15391970,18586724,2000,0.45298886413939277,0.5470111358606072
1947,The Fighting Temptations,33972062,30250745,3721317,2003,0.8904594899185101,0.1095405100814899
1948,The Witness,33963557,418063,33545494,2015,0.012309164202088727,0.9876908357979113
1949,Hotel Rwanda,33882243,23530892,10351351,2004,0.6944903854210597,0.3055096145789404
1950,The Good Liar,33856058,17156058,16700000,2019,0.5067352495674482,0.49326475043255186
1951,Jay and Silent Bob Strike Back,33788161,30085147,3703014,2001,0.890404985343831,0.10959501465616907
1952,The Art of Racing in the Rain,33766787,26395642,7371145,2019,0.7817042823766442,0.21829571762335576
1953,I Want to Eat Your Pancreas,33748006,277019,33470987,2017,0.008208455338072419,0.9917915446619275
1954,Nobody's Fool,33705333,31713110,1992223,2018,0.9408929441521909,0.05910705584780901
1955,The Skin I Live In,33678406,3185812,30492594,2011,0.09459509455405936,0.9054049054459407
1956,Y Tu Mamá También,33616692,13839658,19777034,2001,0.411690061592021,0.588309938407979
1957,Because of Winn-Dixie,33589427,32647042,942385,2005,0.9719439989256143,0.0280560010743857
1958,Friday After Next,33526835,33253609,273226,2002,0.9918505280919001,0.008149471908099885
1959,Red Planet,33463969,17480890,15983079,2000,0.5223794583362182,0.4776205416637817
1960,2016: Obama's America,33449086,33449086,0,2012,1.0,0.0
1961,Get on Up,33448971,30703100,2745871,2014,0.9179086555457865,0.08209134445421355
1962,Wonder Boys,33426588,19393557,14033031,2000,0.5801835652505125,0.41981643474948743
1963,The Perks of Being a Wallflower,33384127,17742948,15641179,2012,0.5314785676438386,0.46852143235616134
1964,The Cave,33296457,15007991,18288466,2005,0.450738377359489,0.5492616226405109
1965,Perfect Strangers,33262366,1014507,32247859,2017,0.03050014541960124,0.9694998545803988
1966,Confessions of a Teenage Drama Queen,33251890,29331068,3920822,2004,0.8820872437626853,0.11791275623731463
1967,Project Almanac,33213241,22348241,10865000,2015,0.6728714310054836,0.32712856899451637
1968,Bharat,33185983,2971549,30214434,2019,0.08954229259986062,0.9104577074001394
1969,Baaghi 2,33139063,1319579,31819484,2018,0.039819442088631175,0.9601805579113688
1970,The Crocodile Hunter: Collision Course,33082548,28442574,4639974,2002,0.8597455673607728,0.14025443263922718
1971,Girl with a Pearl Earring,33030115,11670971,21359144,2003,0.3533433353168767,0.6466566646831232
1972,Confessions of a Dangerous Mind,33013805,16007718,17006087,2002,0.4848795223695057,0.5151204776304943
1973,Lockout,32948113,14326864,18621249,2012,0.43483109336185655,0.5651689066381435
1974,Inside Llewyn Davis,32935319,13235319,19700000,2013,0.40185792644060925,0.5981420735593908
1975,Sleepless,32917353,20783704,12133649,2017,0.6313905009312262,0.3686094990687738
1976,Brightburn,32893421,17300439,15592982,2019,0.5259543846169117,0.4740456153830883
1977,Adaptation.,32801173,22498520,10302653,2002,0.6859059583021619,0.31409404169783806
1978,Katy Perry: Part of Me,32726956,25326071,7400885,2012,0.7738596586862524,0.2261403413137476
1979,Leap Year,32686500,25918920,6767580,2010,0.7929548896333348,0.20704511036666515
1980,Mud,32613173,21590086,11023087,2013,0.6620050738393348,0.3379949261606652
1981,Cry Wolf,32586408,10047674,22538734,2005,0.30833941562383926,0.6916605843761607
1982,The Musketeer,32533802,27073640,5460162,2001,0.832169569360507,0.16783043063949304
1983,The Hurricane Heist,32517248,6115825,26401423,2018,0.18807941557661953,0.8119205844233804
1984,UglyDolls,32450241,20150241,12300000,2019,0.6209581309426947,0.3790418690573053
1985,Movie 43,32438988,8840453,23598535,2012,0.2725255485775327,0.7274744514224674
1986,Stuber,32390945,22370452,10020493,2019,0.6906390659488323,0.3093609340511677
1987,Kevin Hart: Let Me Explain,32318051,32244051,74000,2013,0.997710257960791,0.002289742039208986
1988,Potiche,32309881,1618844,30691037,2010,0.050103681904616115,0.9498963180953839
1989,Hart's War,32287044,19077641,13209403,2002,0.5908760492289106,0.4091239507710895
1990,Seven Psychopaths,32226382,15024049,17202333,2012,0.4662034044032619,0.5337965955967381
1991,Reindeer Games,32168970,23368995,8799975,2000,0.7264452358903627,0.2735547641096373
1992,The Kid Who Would Be King,32140970,16790790,15350180,2019,0.5224108046521309,0.4775891953478691
1993,You Again,32054369,25702053,6352316,2010,0.8018268274131367,0.1981731725868633
1994,Dilwale,31994323,4871263,27123060,2015,0.15225397955756087,0.8477460204424391
1995,Suffragette,31972096,4702420,27269676,2015,0.1470788777814254,0.8529211222185746
1996,Bad Times at the El Royale,31882724,17839115,14043609,2018,0.5595229253309724,0.44047707466902764
1997,Self/less,31807156,12279691,19527465,2015,0.38606692783221486,0.6139330721677851
1998,Blood Work,31794718,26235081,5559637,2002,0.825139603376888,0.17486039662311206
1999,Spring Breakers,31724284,14124284,17600000,2013,0.44521994570468476,0.5547800542953152
2000,Hunter Killer,31672678,15767460,15905218,2018,0.49782528651350544,0.5021747134864946
2001,Rent,31670620,29077547,2593073,2005,0.918123705819463,0.08187629418053705
2002,New World,31670607,457806,31212801,2013,0.014455232891494628,0.9855447671085054
2003,Ae Dil Hai Mushkil,31668920,4264983,27403937,2016,0.1346740905594507,0.8653259094405493
2004,Anna,31640190,7743794,23896396,2019,0.24474549615536442,0.7552545038446355
2005,Super Troopers 2,31626386,30617396,1008990,2018,0.9680965760678442,0.03190342393215589
2006,Double Take,31603059,29831583,1771476,2001,0.9439460591457302,0.05605394085426983
2007,The New World 2005 Re-release,31510855,12712093,18798762,2005,0.4034194883001429,0.596580511699857
2008,The Thing,31505287,16928670,14576617,2011,0.5373279094394537,0.46267209056054626
2009,I Don't Know How She Does It,31410151,9662284,21747867,2011,0.3076166045811114,0.6923833954188886
2010,Lost Souls,31355910,16815253,14540657,2000,0.5362706105483783,0.46372938945162173
2011,Johnson Family Vacation,31326183,31203964,122219,2004,0.9960985032871703,0.003901496712829648
2012,What's in a Name?,31303580,8111,31295469,2012,0.00025910774422605975,0.9997408922557739
2013,How High,31283740,31178740,105000,2001,0.9966436238122424,0.003356376187757602
2014,Tazza: The Hidden Card,31278476,251555,31026921,2014,0.008042431479078457,0.9919575685209215
2015,Saving Mr. Wu,31222161,92696,31129465,2015,0.0029689168536412326,0.9970310831463588
2016,The New Guy,31167388,29760152,1407236,2002,0.9548490877708457,0.0451509122291544
2017,Joyful Noise,31158113,30932113,226000,2012,0.9927466724316714,0.007253327568328673
2018,Premium Rush,31083599,20275446,10808153,2012,0.6522875938529512,0.3477124061470488
2019,The Strangers: Prey at Night,31039126,24586708,6452418,2018,0.7921198554366512,0.20788014456334886
2020,The Wild Goose Lake,31037956,12573,31025383,2019,0.0004050846647247003,0.9995949153352753
2021,Beauty and the Beast 2000 IMAX Release,31033346,25487190,5546156,2001,0.8212839827197492,0.17871601728025074
2022,This Is Not What I Expected,30996615,337670,30658945,2017,0.010893770174581966,0.9891062298254181
2023,Joe Dirt,30987695,27087695,3900000,2001,0.8741435915126956,0.1258564084873044
2024,Playing for Keeps,30962335,13103272,17859063,2012,0.42320038201253235,0.5767996179874677
2025,Billy Lynn's Long Halftime Walk,30930984,1738477,29192507,2016,0.05620503376161586,0.9437949662383841
2026,The Promise,30925693,669625,30256068,2005,0.021652707992671338,0.9783472920073286
2027,Hearts in Atlantis,30919415,24185781,6733634,2001,0.7822198770578292,0.2177801229421708
2028,African Cats,30857747,15428747,15429000,2011,0.499995900543225,0.500004099456775
2029,Attack on Titan Part 1,30810658,449523,30361135,2015,0.014589853939503662,0.9854101460604964
2030,Winter's Tale,30800231,12600231,18200000,2014,0.40909534087585253,0.5909046591241475
2031,Monsoon Wedding,30787356,13885966,16901390,2001,0.45102820781362324,0.5489717921863768
2032,Wolf Creek,30762648,16188180,14574468,2005,0.5262284313105946,0.4737715686894054
2033,Norm of the North,30734502,17062499,13672003,2016,0.5551578157993254,0.44484218420067456
2034,Carnage,30722632,2547047,28175585,2011,0.08290458317503527,0.9170954168249648
2035,A Man Called Ove,30691696,3479315,27212381,2015,0.11336339966354417,0.8866366003364559
2036,A Wedding Invitation,30665036,14350,30650686,2013,0.0004679596658552757,0.9995320403341448
2037,When the Bough Breaks,30658387,29747603,910784,2016,0.9702925010373181,0.02970749896268189
2038,Wild Tales,30642704,3106530,27536174,2014,0.10137910805782675,0.8986208919421732
2039,City of God,30641770,7564459,23077311,2002,0.2468675601964247,0.7531324398035754
2040,Cabin Fever,30553394,21158188,9395206,2003,0.6924987777135332,0.30750122228646676
2041,Two for the Money,30526509,22991379,7535130,2005,0.7531610968027821,0.24683890319721788
2042,A Dangerous Method,30519436,5704709,24814727,2011,0.18692052500577008,0.81307947499423
2043,What's Your Number?,30426096,14011084,16415012,2011,0.4604956219161341,0.5395043780838659
2044,The Girl Next Door,30381722,14589444,15792278,2004,0.4802046440948936,0.5197953559051064
2045,Nocturnal Animals,30311857,10663357,19648500,2016,0.3517883117487655,0.6482116882512345
2046,Far from the Madding Crowd,30229977,12236500,17993477,2015,0.40478032781831097,0.595219672181689
2047,A Silent Voice: The Movie,30156463,310407,29846056,2016,0.010293216415996797,0.9897067835840032
2048,When the Game Stands Tall,30138754,30127963,10791,2014,0.9996419560012335,0.0003580439987665051
2049,The Rum Diary,30134958,13109815,17025143,2011,0.4350367768888213,0.5649632231111787
2050,Godsend,30120671,14379751,15740920,2004,0.47740473643498843,0.5225952635650115
2051,Shaun of the Dead,30076102,13542874,16533228,2004,0.45028687560642,0.54971312439358
2052,Laws of Attraction,30031874,17871255,12160619,2003,0.5950762513188488,0.4049237486811512
2053,Solaris,30002758,14973382,15029376,2002,0.49906685245403104,0.500933147545969
2054,Reset 2017 Re-release,29949252,108970,29840282,2017,0.0036384881999724067,0.9963615118000276
2055,Small Time Crooks,29934477,17266359,12668118,2000,0.5768051000189514,0.4231948999810486
2056,Keeping Up with the Joneses,29918745,14904426,15014319,2016,0.4981634757741342,0.5018365242258658
2057,The Four Feathers,29882645,18306166,11576479,2002,0.6126019299831056,0.3873980700168944
2058,The Bye Bye Man,29874280,22395806,7478474,2017,0.7496684773658143,0.2503315226341857
2059,Draft Day,29824199,28842237,981962,2014,0.9670749916871195,0.03292500831288042
2060,The Disaster Artist,29820616,21120616,8700000,2017,0.7082555236283516,0.2917444763716484
2061,Like a Boss,29753143,22169514,7583629,2020,0.7451150286878936,0.2548849713121064
2062,Battlefield Earth,29725663,21471685,8253978,2000,0.7223282118215496,0.2776717881784504
2063,The Swindlers,29721916,241916,29480000,2017,0.008139313764294335,0.9918606862357057
2064,Angel Eyes,29715606,24174218,5541388,2001,0.8135192666102787,0.1864807333897212
2065,The Raven,29699345,16008272,13691073,2012,0.5390109445174632,0.4609890554825367
2066,Masterminds,29674699,17368022,12306677,2016,0.5852804774868988,0.4147195225131011
2067,Amour,29652180,6739492,22912688,2012,0.22728487416439533,0.7727151258356046
2068,Cursed,29621722,19297522,10324200,2005,0.6514652321698245,0.34853476783017545
2069,The Pledge,29419291,19733089,9686202,2001,0.670753384233495,0.32924661576650505
2070,City by the Sea,29414087,22449000,6965087,2002,0.7632057388012757,0.23679426119872427
2071,Luther,29413900,5791328,23622572,2003,0.19689085772372925,0.8031091422762707
2072,The Losers,29397654,23591432,5806222,2010,0.8024936955853689,0.19750630441463118
2073,Bugs!,29388999,19063544,10325455,2003,0.6486625828936875,0.35133741710631244
2074,Baby Boy,29381649,28734552,647097,2001,0.977976151032231,0.022023848967768964
2075,Nurse Betty,29360400,25170054,4190346,2000,0.8572789880246863,0.1427210119753137
2076,Mr. Holmes,29355203,17737646,11617557,2015,0.6042419805443008,0.3957580194556992
2077,Rowdy Rathore,29342463,777373,28565090,2012,0.02649310659435781,0.9735068934056422
2078,Sword Art Online The Movie: Ordinal Scale,29322339,1522976,27799363,2017,0.05193910349375607,0.9480608965062439
2079,Free Solo,29318861,17541090,11777771,2018,0.5982868843370143,0.4017131156629857
2080,Big Eyes,29253166,14482031,14771135,2014,0.495058586137309,0.504941413862691
2081,Bloodshot,29169577,10021787,19147790,2020,0.34356984333368973,0.6564301566663102
2082,Yu-Gi-Oh!: The Movie - Pyramid of Light,29144802,19765868,9378934,2004,0.6781953090640314,0.32180469093596864
2083,Special ID,29139936,12666,29127270,2013,0.0004346612154535961,0.9995653387845465
2084,Cold Creek Manor,29119434,21386011,7733423,2003,0.7344239932685505,0.26557600673144954
2085,Sacrifice,29093560,29792,29063768,2010,0.0010240066873906115,0.9989759933126093
2086,Pad Man,29045020,1670192,27374828,2018,0.057503558269197265,0.9424964417308027
2087,Far from Heaven,29027914,15901849,13126065,2002,0.5478123229936537,0.4521876770063464
2088,M.S. Dhoni: The Untold Story,28903047,1801550,27101497,2016,0.06233079854867897,0.937669201451321
2089,Twilight/The Twilight Saga: New Moon,28858846,2385237,26473609,2010,0.082651849626974,0.917348150373026
2090,Agent Cody Banks 2: Destination London,28818995,23630159,5188836,2004,0.8199508345103638,0.18004916548963626
2091,Boiler Room,28780255,16970581,11809674,2000,0.5896605502626714,0.4103394497373286
2092,Speak Bachchan,28775262,1216258,27559004,2012,0.04226748656536993,0.9577325134346301
2093,Twins 2,28733523,1431255,27302268,2017,0.04981133013170713,0.9501886698682929
2094,The Suspect,28674130,218693,28455437,2013,0.007626839942484741,0.9923731600575153
2095,Wrong Turn,28650575,15418790,13231785,2003,0.5381668605254868,0.46183313947451315
2096,The Fortress,28645448,252895,28392553,2017,0.008828453302598025,0.9911715466974019
2097,Love & Mercy,28641776,12551031,16090745,2015,0.43820714888629814,0.5617928511137019
2098,Heist,28510652,23510841,4999811,2001,0.8246335790566979,0.17536642094330218
2099,I Give It a Year,28328531,34657,28293874,2013,0.0012233955936507969,0.9987766044063492
2100,Brown Sugar,28316451,27363891,952560,2002,0.9663601911129329,0.0336398088870671
2101,Thunderbirds,28283637,6880917,21402720,2004,0.24328260895159984,0.7567173910484002
2102,The Master,28258060,16377274,11880786,2012,0.5795611588339752,0.42043884116602487
2103,Fan,28240000,2300000,25940000,2016,0.08144475920679886,0.9185552407932012
2104,The Upside of Anger,28237488,18761993,9475495,2005,0.664435625435237,0.33556437456476296
2105,L'auberge espagnole,28193749,1067438,27126311,2002,0.03786080382569909,0.9621391961743009
2106,Gully Boy,28141995,5566534,22575461,2019,0.19780168392468267,0.8021983160753173
2107,Pokemon 4Ever: Celebi - Voice of the Forest,28023563,1727447,26296116,2002,0.06164266121335107,0.938357338786649
2108,Your Highness,28013733,21596445,6417288,2011,0.7709234967007075,0.22907650329929252
2109,The Tailor of Panama,28008462,13729742,14278720,2001,0.4901997831940933,0.5098002168059067
2110,Mandela: Long Walk to Freedom,27985788,8323085,19662703,2013,0.29740398948208996,0.70259601051791
2111,The Brothers Grimsby,27979040,6874837,21104203,2016,0.24571382720779555,0.7542861727922044
2112,The 33,27972023,12227722,15744301,2015,0.4371411392018375,0.5628588607981625
2113,The Little Vampire,27965865,13572400,14393465,2000,0.4853202287860576,0.5146797712139424
2114,The Brothers,27958191,27457409,500782,2001,0.9820881830301539,0.017911816969846152
2115,The Divine Move,27926871,136707,27790164,2014,0.004895177837860891,0.9951048221621391
2116,Monster Family,27890108,127259,27762849,2017,0.004562872255639885,0.9954371277443601
2117,Mrs. Henderson Presents,27876417,11036366,16840051,2005,0.3959033185649361,0.6040966814350639
2118,The Beguiled,27869129,10709995,17159134,2017,0.3842960072415611,0.6157039927584389
2119,Dark Skies,27858103,17418667,10439436,2013,0.6252639312877837,0.3747360687122163
2120,Love & Basketball,27728118,27459615,268503,2000,0.9903165804473278,0.009683419552672129
2121,Ruby & Quentin,27720972,312824,27408148,2003,0.011284741386413145,0.9887152586135869
2122,Default,27694043,203775,27490268,2018,0.007358080580722721,0.9926419194192773
2123,Dirty Dancing: Havana Nights,27685016,14161590,13523426,2004,0.5115254403320554,0.48847455966794456
2124,Nebraska,27682872,17654912,10027960,2013,0.6377557935462765,0.36224420645372346
2125,The Quiet American,27674124,12988801,14685323,2002,0.46934822580111296,0.530651774198887
2126,Ice Princess,27645491,24402491,3243000,2005,0.882693347714461,0.11730665228553908
2127,The Last Castle,27642707,18244060,9398647,2001,0.659995419406645,0.34000458059335503
2128,Goal! The Dream Begins,27610873,4283255,23327618,2005,0.15512928548112187,0.8448707145188781
2129,One Cut of the Dead,27590180,52406,27537774,2018,0.0018994439325876091,0.9981005560674124
2130,Cirque du Soleil: Journey of Man,27538359,15627434,11910925,2000,0.5674787666178657,0.43252123338213433
2131,The Women on the 6th Floor,27533970,719823,26814147,2011,0.026143087974600104,0.9738569120253999
2132,Mirai,27526961,812794,26714167,2018,0.029527196990615855,0.9704728030093841
2133,The Happytime Murders,27506452,20706452,6800000,2018,0.7527852737968532,0.2472147262031468
2134,The Incredible Burt Wonderstone,27437881,22537881,4900000,2013,0.8214147805364416,0.17858521946355843
2135,Left Behind,27405896,14019924,13385972,2014,0.5115659783573578,0.48843402164264216
2136,Irrational Man,27391084,4030360,23360724,2015,0.14714131065422603,0.852858689345774
2137,Legend of the Fist: The Return of Chen Zhen,27390678,50433,27340245,2010,0.0018412468650830767,0.998158753134917
2138,Ella Enchanted,27388767,22918387,4470380,2004,0.8367805312301938,0.16321946876980625
2139,Detective K: Secret of the Lost Island,27387870,185367,27202503,2015,0.006768215271943382,0.9932317847280566
2140,Midnight Sun,27365467,9561064,17804403,2018,0.34938428056060583,0.6506157194393942
2141,Ramona and Beezus,27293743,26167002,1126741,2010,0.9587179742990912,0.04128202570090881
2142,American Ultra,27262374,14440985,12821389,2015,0.5297038695162791,0.4702961304837209
2143,Khumba,27187375,1029,27186346,2013,3.7848449877930475e-05,0.999962151550122
2144,The Protector,27165581,12044087,15121494,2005,0.44335834378068334,0.5566416562193166
2145,Splice 2010 Re-release,27127620,17010170,10117450,2010,0.627042475528631,0.37295752447136904
2146,Let Me In,27093592,12134935,14958657,2010,0.4478894861928976,0.5521105138071024
2147,My Neighbor Totoro 2018 Re-release,27083857,1144649,25939208,2018,0.042263145902741994,0.9577368540972581
2148,Hitchcock,27039669,6008677,21030992,2012,0.22221710628188532,0.7777828937181147
2149,The Crime of Padre Amaro,26996738,5717044,21279694,2002,0.21176795507664667,0.7882320449233533
2150,Total Dhamaal,26911995,2167632,24744363,2019,0.08054519926895051,0.9194548007310495
2151,You're Next,26895481,18494006,8401475,2013,0.6876250326216512,0.3123749673783488
2152,The In-Laws,26891849,20453431,6438418,2003,0.7605810593388354,0.23941894066116465
2153,Chips,26800152,18600152,8200000,2017,0.6940315860895118,0.3059684139104883
2154,Doogal,26711924,7438000,19273924,2005,0.27845242446781443,0.7215475755321855
2155,A Cure for Wellness,26620002,8106986,18513016,2017,0.3045449057441844,0.6954550942558156
2156,No Manches Frida 2,26493648,9270920,17222728,2019,0.3499299152762957,0.6500700847237043
2157,A Hard Day,26488847,19004,26469843,2014,0.0007174340204388662,0.9992825659795611
2158,"The Way, Way Back",26474920,21506546,4968374,2013,0.8123365811870253,0.18766341881297469
2159,Center Stage,26385941,17200925,9185016,2000,0.65189734942559,0.3481026505744101
2160,Only the Brave,26351322,18343983,8007339,2017,0.6961314123063731,0.3038685876936269
2161,Saving Grace,26330482,12178602,14151880,2000,0.46252863886046597,0.537471361139534
2162,All About the Benjamins,26306533,25916319,390214,2002,0.9851666504286216,0.014833349571378334
2163,Aloha,26250020,21067116,5182904,2015,0.8025561885286182,0.19744381147138174
2164,Missing Link,26249469,16649539,9599930,2019,0.6342809829791224,0.36571901702087767
2165,Apollo 18,26236153,17687709,8548444,2011,0.6741731152429246,0.3258268847570755
2166,Typhoon,26179656,139059,26040597,2005,0.005311719909535863,0.9946882800904642
2167,The Whole Ten Yards,26170671,16328471,9842200,2004,0.6239225199842985,0.37607748001570157
2168,The Zookeeper's Wife,26152835,17571660,8581175,2017,0.6718835644395722,0.32811643556042774
2169,Badrinath Ki Dulhania,26134309,1993259,24141050,2017,0.0762698183449197,0.9237301816550803
2170,Top Five,26117471,25317471,800000,2014,0.9693691628871723,0.030630837112827655
2171,Saving Silverman,26086706,19402030,6684676,2001,0.7437516258281134,0.2562483741718866
2172,Hichki,26055222,330279,25724943,2018,0.012676115367583512,0.9873238846324165
2173,Iceman,26033917,7679,26026238,2014,0.0002949613767302093,0.9997050386232698
2174,The Light Between Oceans,25975621,12545979,13429642,2016,0.48299053177592943,0.5170094682240706
2175,White Boy Rick,25957482,24011188,1946294,2018,0.925019922964793,0.07498007703520704
2176,"Paul, Apostle of Christ",25915966,17560475,8355491,2018,0.6775929170458087,0.32240708295419124
2177,Huevos: Little Rooster's Egg-cellent Adventure,25892561,9080818,16811743,2015,0.3507114649647827,0.6492885350352172
2178,Rollerball,25852764,18990798,6861966,2002,0.7345751502624632,0.26542484973753677
2179,Boys and Girls,25850615,21799652,4050963,2000,0.8432933607188843,0.15670663928111575
2180,The Alamo,25819961,22414961,3405000,2004,0.8681252849297487,0.13187471507025128
2181,Rust and Bone,25807712,2062027,23745685,2012,0.07989964395138942,0.9201003560486106
2182,Our Idiot Brother,25804448,24816118,988330,2011,0.9616992388289026,0.038300761171097326
2183,Fair Game,25798915,9540691,16258224,2010,0.3698097768840279,0.6301902231159722
2184,"The Gangster, the Cop, the Devil",25775371,216494,25558877,2019,0.008399258346271718,0.9916007416537282
2185,A Beautiful Planet,25730120,15650615,10079505,2016,0.6082604744944835,0.3917395255055165
2186,Fireworks,25672406,525280,25147126,2017,0.020460879280266915,0.979539120719733
2187,Jonah: A VeggieTales Movie,25615231,25581229,34002,2002,0.9986725866341006,0.0013274133658993745
2188,Father Figures,25601244,17501244,8100000,2017,0.6836091246191005,0.31639087538089944
2189,"Love, Rosie",25574387,20431,25553956,2014,0.0007988852284123173,0.9992011147715877
2190,Mr. Donkey,25537759,356255,25181504,2016,0.013950127730471574,0.9860498722695284
2191,The Tiger and the Snow,25460023,10167,25449856,2005,0.00039933192519111236,0.9996006680748089
2192,In America,25382911,15539656,9843255,2003,0.6122093718880391,0.38779062811196086
2193,Keys To The Heart,25375866,75134,25300732,2018,0.0029608447648643795,0.9970391552351356
2194,A Haunted House 2,25358716,17329486,8029230,2014,0.6833739531607199,0.31662604683928003
2195,And So It Goes,25312387,15160801,10151586,2014,0.5989478985130877,0.40105210148691234
2196,Enough Said,25288872,17550872,7738000,2013,0.6940156128751017,0.3059843871248983
2197,Corky Romano,25272752,23980304,1292448,2001,0.9488600212592597,0.05113997874074022
2198,North Country,25211175,18337722,6873453,2005,0.7273648292870126,0.2726351707129874
2199,Emma.,25155355,10055355,15100000,2020,0.3997301966122124,0.6002698033877876
2200,Biutiful,25147786,5101237,20046549,2010,0.20285034237208793,0.797149657627912
2201,On the Other Side of the Tracks,25109572,9572,25100000,2012,0.0003812092057961004,0.9996187907942039
2202,Born in China,25081168,13873211,11207957,2016,0.5531325734112542,0.4468674265887458
2203,Race,25070261,19206207,5864054,2016,0.7660952153629353,0.2339047846370646
2204,The Last Exorcism 2,25051865,15179302,9872563,2013,0.6059150486400913,0.39408495135990873
2205,Free State of Jones,25035950,20810036,4225914,2016,0.8312061655339622,0.16879383446603785
2206,Whiskey Tango Foxtrot,24972139,23083334,1888805,2016,0.924363507667485,0.07563649233251504
2207,The Way Home,24952738,445367,24507371,2002,0.017848422084983218,0.9821515779150167
2208,Booksmart,24863452,22680962,2182490,2019,0.9122209578943423,0.08777904210565773
2209,Seed of Chucky,24829644,17083732,7745912,2004,0.6880377342502373,0.31196226574976266
2210,Wild City,24817852,34866,24782986,2015,0.0014048758127818636,0.9985951241872182
2211,Elle s'appelait Sarah,24792815,7693187,17099628,2010,0.31029905236658284,0.6897009476334172
2212,Lottery Ticket,24719879,24719879,0,2010,1.0,0.0
2213,Big Miracle,24719215,20157300,4561915,2012,0.815450652458017,0.18454934754198302
2214,Bride & Prejudice,24716440,6605592,18110848,2004,0.26725499303297723,0.7327450069670227
2215,Super 30,24701637,2269878,22431759,2019,0.09189180457959123,0.9081081954204088
2216,The Shipping News,24690441,11434216,13256225,2001,0.4631029474119154,0.5368970525880846
2217,Drug War,24676341,128195,24548146,2013,0.005195057079167451,0.9948049429208325
2218,Punch-Drunk Love,24665649,17844216,6821433,2002,0.7234440091156734,0.27655599088432664
2219,The Death of Stalin,24646055,8047856,16598199,2017,0.32653728963925466,0.6734627103607453
2220,The Snow Queen 3: Fire and Ice,24644317,0,24644317,2016,0.0,1.0
2221,Sparkle,24637800,24397469,240331,2012,0.9902454358749564,0.009754564125043632
2222,The Players,24629152,10854,24618298,2012,0.00044069726801799754,0.999559302731982
2223,Capture the Flag,24604331,6690,24597641,2015,0.00027190334904858825,0.9997280966509514
2224,Joe Somebody,24516772,22771646,1745126,2001,0.9288190957602412,0.07118090423975881
2225,God's Not Dead 2,24487848,20774575,3713273,2016,0.8483626245964937,0.15163737540350627
2226,Stan & Ollie,24420923,5470235,18950688,2018,0.22399788083357866,0.7760021191664214
2227,Down to You,24419914,20069008,4350906,2000,0.8218295936668737,0.1781704063331263
2228,The Tale of The Princess Kaguya,24366656,703232,23663424,2013,0.02886042303055454,0.9711395769694454
2229,The Next Best Thing,24362772,14990582,9372190,2000,0.61530691170939,0.38469308829060994
2230,Nowhere in Africa,24322180,6180200,18141980,2001,0.25409728897656375,0.7459027110234362
2231,The Great Beauty,24271739,2852400,21419339,2013,0.11751939158541545,0.8824806084145845
2232,Jackie,24270399,13960394,10310005,2016,0.5752024925506993,0.42479750744930067
2233,Trance,24261569,2328743,21932826,2013,0.09598484747626998,0.90401515252373
2234,The Accidental Detective 2: In Action,24243825,179045,24064780,2018,0.0073851795250955655,0.9926148204749045
2235,Jolly LLB 2,24214186,1654254,22559932,2017,0.06831755566757437,0.9316824443324256
2236,The Gunman,24177137,10664749,13512388,2015,0.44110884593159233,0.5588911540684077
2237,The Railway Man,24174885,4438438,19736447,2013,0.18359706778336277,0.8164029322166372
2238,The Way Back,24172201,2701859,21470342,2010,0.11177546471668012,0.8882245352833199
2239,The Guru,24128852,3095506,21033346,2002,0.12829064557236292,0.8717093544276371
2240,The Founder,24121245,12786053,11335192,2016,0.5300743390318369,0.46992566096816313
2241,Bad Santa 2,24079268,17782178,6297090,2016,0.7384849904905747,0.2615150095094253
2242,Kung Fu Jungle,24070765,129784,23940981,2014,0.0053917688116684286,0.9946082311883315
2243,I Can Speak,24024444,63239,23961205,2017,0.0026322773588433514,0.9973677226411567
2244,Harold & Kumar Go to White Castle,23936908,18250550,5686358,2004,0.7624439213285191,0.23755607867148087
2245,25th Hour,23928503,13084595,10843908,2002,0.5468204592656716,0.4531795407343284
2246,Birth,23925492,5095038,18830454,2004,0.21295436683182942,0.7870456331681706
2247,Life as a House,23903791,15667270,8236521,2001,0.6554303457556168,0.34456965424438324
2248,Spirits' Homecoming,23857217,125616,23731601,2016,0.0052653249538703525,0.9947346750461297
2249,Silence,23834809,7100177,16734632,2016,0.2978910802264033,0.7021089197735967
2250,Lady Vengeance,23834149,211667,23622482,2005,0.00888082893163083,0.9911191710683692
2251,Eight Crazy Nights,23833131,23586598,246533,2002,0.9896558702253598,0.010344129774640184
2252,Wanderlust,23812816,17450535,6362281,2012,0.7328211413551425,0.26717885864485746
2253,Dickie Roberts: Former Child Star,23769505,22738671,1030834,2003,0.9566320796331266,0.04336792036687344
2254,The Dressmaker,23762417,2022115,21740302,2015,0.08509719360618913,0.9149028063938108
2255,Pokémon the Movie: The Power of Us,23740788,789170,22951618,2018,0.0332411038757433,0.9667588961242567
2256,Russian Dolls,23727301,326095,23401206,2005,0.013743451056654105,0.9862565489433459
2257,In the Cut,23726793,4750602,18976191,2003,0.20022099067497237,0.7997790093250277
2258,Amy,23706049,8413144,15292905,2015,0.3548943984718837,0.6451056015281164
2259,To the Arctic 3D,23695388,14560838,9134550,2012,0.6145009315736886,0.3854990684263115
2260,The Glass House,23619609,18150259,5469350,2001,0.7684402819707981,0.23155971802920192
2261,What Now?,23591043,23591043,0,2016,1.0,0.0
2262,Hustle & Flow,23563727,22202809,1360918,2005,0.9422452144348812,0.057754785565118795
2263,No manches Frida,23540937,11528613,12012324,2016,0.48972617360133114,0.5102738263986688
2264,Biker Boyz,23510621,22076772,1433849,2003,0.9390127125948736,0.06098728740512639
2265,Youth,23469540,2703296,20766244,2015,0.11518316933352762,0.8848168306664723
2266,Wish Upon,23468586,14301505,9167081,2017,0.6093892917110558,0.39061070828894423
2267,Tomcats,23430766,13558739,9872027,2001,0.5786724599614029,0.4213275400385971
2268,Kingdom Come,23396049,23249649,146400,2001,0.9937425331943868,0.006257466805613204
2269,Antwone Fisher,23367586,21078145,2289441,2002,0.9020249246113826,0.09797507538861738
2270,Detroit,23355100,16790139,6564961,2017,0.7189067484189748,0.2810932515810251
2271,Middle School: The Worst Years of My Life,23316139,20007149,3308990,2016,0.8580815631610362,0.14191843683896377
2272,Warrior,23308615,13657115,9651500,2011,0.5859256330760108,0.41407436692398925
2273,Super Troopers,23182223,18492362,4689861,2002,0.7976958033748532,0.2023041966251468
2274,Triple 9,23177948,12639297,10538651,2016,0.5453156163781194,0.4546843836218806
2275,Hoodwinked! 2011 Re-release,23167844,10143779,13024065,2011,0.4378387130023838,0.5621612869976161
2276,Rock Dog,23157646,9420546,13737100,2016,0.40680067395451164,0.5931993260454884
2277,The Peanut Butter Falcon,23065606,20457151,2608455,2019,0.886911490641087,0.113088509358913
2278,The Choice,23064015,18730891,4333124,2016,0.8121262061267304,0.1878737938732697
2279,Confidence,23014206,12251640,10762566,2003,0.5323511921288964,0.46764880787110363
2280,Padmaavat,22991060,11846060,11145000,2018,0.5152463609768319,0.48475363902316815
2281,The Human Stain,22954068,5381908,17572160,2003,0.23446423527193525,0.7655357647280647
2282,Domino,22944502,10169202,12775300,2005,0.4432086606194373,0.5567913393805627
2283,Young Adult,22939027,16311571,6627456,2011,0.7110838223434673,0.28891617765653266
2284,A Separation,22926076,7099055,15827021,2011,0.30964980662194436,0.6903501933780556
2285,Baggage Claim,22871096,21569509,1301587,2013,0.9430903092707057,0.056909690729294304
2286,Dr. T & the Women,22844291,13113041,9731250,2000,0.5740182962999377,0.42598170370006233
2287,Won't You Be My Neighbor?,22843944,22835787,8157,2018,0.9996429250570742,0.0003570749429257925
2288,Kon-Tiki,22842887,1517410,21325477,2012,0.06642811830220935,0.9335718816977907
2289,Sweet Sixteen,22819702,34327,22785375,2016,0.001504270301163442,0.9984957296988366
2290,Captain Fantastic,22787526,5879835,16907691,2016,0.2580286688427695,0.7419713311572305
2291,Extraordinary Mission,22757764,54174,22703590,2017,0.0023804623336457836,0.9976195376663543
2292,Black and Blue,22741061,22055313,685748,2019,0.9698453823240701,0.030154617675929897
2293,Fading Gigolo,22706304,3769873,18936431,2014,0.1660275930420028,0.8339724069579972
2294,Live by Night,22678555,10378555,12300000,2016,0.45763740238300016,0.5423625976169999
2295,EuroTrip,22605153,17771387,4833766,2004,0.7861653048753973,0.2138346951246028
2296,Hunt for the Wilderpeople,22519390,5205468,17313922,2016,0.2311549291521662,0.7688450708478338
2297,The Farewell,22517864,17695781,4822083,2019,0.7858552214366336,0.2141447785633664
2298,Julieta,22468044,1490948,20977096,2016,0.06635860246668557,0.9336413975333144
2299,Swimming Pool,22441497,10130108,12311389,2003,0.45140072429214506,0.5485992757078549
2300,Two Can Play That Game,22391450,22235901,155549,2001,0.9930531966442548,0.006946803355745161
2301,Late Night,22386555,15499454,6887101,2019,0.6923554785450463,0.30764452145495363
2302,Mojin: The Worm Valley,22381583,101516,22280067,2018,0.004535693476194244,0.9954643065238058
2303,The Contender,22361811,17872723,4489088,2000,0.7992520373238107,0.20074796267618933
2304,Solace,22354572,0,22354572,2015,0.0,1.0
2305,Twenty,22271862,136125,22135737,2015,0.006111972137758397,0.9938880278622416
2306,Fei chang xing yun,22259179,64432,22194747,2013,0.0028946260776284696,0.9971053739223715
2307,NASCAR: The IMAX Experience,22248831,21583831,665000,2004,0.970110789191576,0.029889210808424046
2308,Fifty Shades of Black,22227514,11686940,10540574,2015,0.5257870943192298,0.47421290568077024
2309,Upside Down,22187813,105095,22082718,2012,0.004736609236791386,0.9952633907632086
2310,Mr. Turner,22179785,3958500,18221285,2014,0.17847332604892246,0.8215266739510775
2311,Ghosts of the Abyss,22141539,17040871,5100668,2003,0.7696335381203628,0.2303664618796372
2312,Sabotage,22126842,10508518,11618324,2014,0.4749217262906293,0.5250782737093708
2313,The Glass Castle,22088533,17273059,4815474,2017,0.7819921313923383,0.21800786860766172
2314,Little Black Book,22035509,20698668,1336841,2004,0.9393324202313639,0.06066757976863616
2315,Big Brother,22029250,85624,21943626,2018,0.0038868322798097984,0.9961131677201902
2316,Love Don't Cost a Thing,21964072,21924226,39846,2003,0.9981858555189584,0.0018141444810415846
2317,Bullet to the Head,21947209,9489829,12457380,2013,0.4323934309824999,0.5676065690175002
2318,Leap! 2017 Re-release,21929861,21858070,71791,2017,0.9967263358395204,0.003273664160479631
2319,Mr 3000,21839377,21811187,28190,2004,0.9987092122637015,0.0012907877362985218
2320,Black or White,21833967,21571189,262778,2015,0.9879647157110754,0.012035284288924683
2321,Master Z: The Ip Man Legacy,21832649,209454,21623195,2018,0.009593613674639298,0.9904063863253607
2322,The Barbarian Invasions 2003 Re-release,21815430,3435749,18379681,2003,0.1574916928064219,0.8425083071935782
2323,Welcome Back,21775694,1388365,20387329,2015,0.0637575546386719,0.9362424453613281
2324,Diana,21766271,335359,21430912,2013,0.015407278536594533,0.9845927214634055
2325,Legends of Oz: Dorothy's Return,21755418,8462347,13293071,2014,0.38897652989246173,0.6110234701075383
2326,Proud Mary,21753365,20877013,876352,2018,0.9597141867476595,0.0402858132523405
2327,22 Bullets,21695883,0,21695883,2010,0.0,1.0
2328,White Oleander,21672284,16357770,5314514,2002,0.7547783150128523,0.24522168498714764
2329,Just Wright,21584424,21540363,44061,2010,0.9979586668608807,0.0020413331391192094
2330,Man of the House,21577624,19699706,1877918,2005,0.91296919438396,0.08703080561604003
2331,Dark Waters,21570073,11136084,10433989,2019,0.516274747887965,0.48372525211203504
2332,Wicker Park,21568818,13001257,8567561,2004,0.6027802265288714,0.3972197734711286
2333,It Follows,21528593,14674076,6854517,2015,0.6816086866429218,0.3183913133570782
2334,Win a Date with Tad Hamilton!,21513434,17071962,4441472,2004,0.7935489053026124,0.20645109469738768
2335,My Soul to Take,21500813,14744435,6756378,2010,0.6857617430559486,0.3142382569440514
2336,Winged Migration,21493351,924651,20568700,2001,0.04302032754222457,0.9569796724577754
2337,The Merchant of Venice,21417725,3765585,17652140,2004,0.17581629234664278,0.8241837076533572
2338,Our Family Wedding,21409028,20255281,1153747,2010,0.9461093235993713,0.053890676400628744
2339,Love & Friendship,21401949,14016568,7385381,2016,0.6549201663829776,0.34507983361702244
2340,Shaft,21360215,21360215,0,2019,1.0,0.0
2341,Bears,21316745,17780194,3536551,2014,0.8340951679067324,0.16590483209326753
2342,Hotel Mumbai,21314816,9651611,11663205,2019,0.4528123067072219,0.5471876932927782
2343,Love Live! The School Idol Movie,21292009,115840,21176169,2015,0.005440538748598124,0.9945594612514018
2344,New York Minute,21289826,14071441,7218385,2004,0.6609467357788645,0.33905326422113546
2345,Gretel & Hansel,21288630,15347654,5940976,2020,0.7209319716675051,0.27906802833249483
2346,Michael Jordan to the Max,21268532,18650521,2618011,2000,0.8769068311813905,0.12309316881860957
2347,I'm So Excited!,21245677,1368119,19877558,2013,0.06439517083875464,0.9356048291612453
2348,The Prison,21205329,207481,20997848,2017,0.009784380143312088,0.9902156198566879
2349,The Prodigy,21150265,14856291,6293974,2018,0.7024163054221779,0.2975836945778221
2350,Mindhunters,21148829,4480744,16668085,2004,0.2118672386069224,0.7881327613930776
2351,The Jacket,21126225,6303762,14822463,2005,0.2983856320757731,0.7016143679242269
2352,Beasts of the Southern Wild,21107746,12795746,8312000,2012,0.6062109142302546,0.39378908576974536
2353,Unplanned,21051915,19005109,2046806,2019,0.9027734056497948,0.0972265943502052
2354,Gonjiam: Haunted Asylum,21041950,115252,20926698,2018,0.005477249019221127,0.9945227509807789
2355,Yves Saint Laurent,21026290,723593,20302697,2014,0.034413726815334514,0.9655862731846655
2356,My Hero Academia: Two Heroes,21022724,5754556,15268168,2018,0.27373027396449673,0.7262697260355033
2357,The Infiltrator,21011110,15436808,5574302,2016,0.7346974053250875,0.26530259467491246
2358,Before Midnight,20994648,8114627,12880021,2013,0.38650931418330997,0.6134906858166901
2359,71: Into the Fire,20967660,176638,20791022,2010,0.008424306765752593,0.9915756932342474
2360,El nino,20918976,1237,20917739,2014,5.9132913580473535e-05,0.9999408670864195
2361,Amores Perros,20908467,5408467,15500000,2001,0.2586735316367288,0.7413264683632712
2362,The Devil's Rejects,20901859,17044981,3856878,2005,0.8154767956285611,0.18452320437143893
2363,Pokémon Heroes,20867919,746381,20121538,2002,0.035766910921975495,0.9642330890780245
2364,A Thousand Words 2012 Re-release,20803842,18450127,2353715,2012,0.8868615229821492,0.11313847701785083
2365,Best in Show,20789556,18715392,2074164,2000,0.900230481112728,0.09976951888727205
2366,SuperFly,20780685,20545116,235569,2018,0.9886640406704591,0.01133595932954087
2367,I Love You Phillip Morris 2010 Re-release,20722843,2037459,18685384,2010,0.09831947286383437,0.9016805271361656
2368,Keanu,20651333,20591853,59480,2016,0.9971197985137328,0.0028802014862672545
2369,Super Size Me,20645757,11536423,9109334,2004,0.5587793656585225,0.4412206343414775
2370,The Front Line,20629645,11018,20618627,2011,0.0005340857780150847,0.9994659142219849
2371,If Beale Street Could Talk,20596567,14915773,5680794,2018,0.7241873366566379,0.275812663343362
2372,The Best Offer,20596350,100035,20496315,2013,0.004856928533453743,0.9951430714665462
2373,Polisse,20590872,211440,20379432,2011,0.010268627768653994,0.989731372231346
2374,The Man with the Iron Fists,20546518,15634090,4912428,2012,0.7609118975779741,0.23908810242202597
2375,Country Strong,20529194,20218921,310273,2010,0.9848862551544888,0.015113744845511227
2376,Cock and Bull,20490872,82778,20408094,2016,0.004039749992094041,0.995960250007906
2377,The Sapphires,20423628,2450867,17972761,2012,0.12000154918607017,0.8799984508139298
2378,That Demon Within,20415934,172343,20243591,2014,0.00844159272850314,0.9915584072714969
2379,The Clan,20381995,201227,20180768,2015,0.009872782325773311,0.9901272176742267
2380,Ladies in Lavender,20377075,6765081,13611994,2004,0.3319947048337409,0.6680052951662592
2381,Burn the Stage: The Movie,20347513,4201819,16145694,2018,0.20650282911724888,0.7934971708827512
2382,Brahms: The Boy II,20311536,12611536,7700000,2020,0.6209050856616654,0.37909491433833464
2383,Cold War 2018 Re-release,20296042,4580048,15715994,2018,0.22566212663533117,0.7743378733646689
2384,Labor Day,20275812,13371528,6904284,2014,0.6594817509651402,0.3405182490348599
2385,Ong-Bak: The Thai Warrior,20235426,4563167,15672259,2003,0.22550387622182996,0.77449612377817
2386,Singh Is Bliing,20224851,919095,19305756,2015,0.045443845297055585,0.9545561547029444
2387,Serving Sara,20146150,16930185,3215965,2002,0.8403682589477394,0.1596317410522606
2388,Melinda and Melinda,20129327,3826280,16303047,2004,0.19008484486341745,0.8099151551365825
2389,Mulholland Drive,20117339,7220243,12897096,2001,0.35890646372266233,0.6410935362773377
2390,I Heart Huckabees,20072172,12785432,7286740,2004,0.6369730191630483,0.3630269808369518
2391,The Bling Ring,20045576,5845732,14199844,2013,0.29162205166865746,0.7083779483313425
2392,Asterix & Obelix: Mission Cleopatra 2002 Re-release,20015611,3115188,16900423,2002,0.155637916824023,0.8443620831759769
2393,The Company You Keep,20014680,5133027,14881653,2012,0.25646310608013717,0.7435368939198628
2394,The Wife,19978189,9601092,10377097,2018,0.48057869509593687,0.5194213049040631
2395,Himalaya 2001 Re-release,19960881,2487878,17473003,2001,0.12463768508013248,0.8753623149198675
2396,Crazy/Beautiful,19937988,16937988,3000000,2001,0.8495334634567941,0.15046653654320585
2397,Ballistic: Ecks vs. Sever,19924033,14307963,5616070,2002,0.7181258432968868,0.2818741567031133
2398,Get Over It,19900366,11576464,8323902,2001,0.5817211603042879,0.4182788396957121
2399,The Rooftop,19833152,85755,19747397,2013,0.0043238210446831645,0.9956761789553168
2400,Summer Catch,19772447,19753553,18894,2001,0.9990444278343494,0.0009555721656505136
2401,The Perfect Man,19770475,16535005,3235470,2005,0.8363483932480125,0.1636516067519875
2402,Gone,19767535,11682205,8085330,2012,0.590979350738471,0.4090206492615291
2403,Thomas and the Magic Railroad,19748009,15933506,3814503,2000,0.8068411352253283,0.1931588647746717
2404,It Comes at Night,19735344,13985117,5750227,2017,0.7086330494163162,0.2913669505836838
2405,Another Year,19722766,3205706,16517060,2010,0.1625383579564854,0.8374616420435146
2406,Brothers,19694450,613775,19080675,2015,0.031164871321615988,0.9688351286783841
2407,Blackhat,19652057,8005980,11646077,2015,0.4073863616414302,0.5926136383585698
2408,Youth in Revolt,19651093,15281286,4369807,2010,0.7776303333356572,0.2223696666643428
2409,Shackleton's Antarctic Adventure,19613216,15553324,4059892,2001,0.7930022287013002,0.2069977712986998
2410,S1m0ne,19576023,9688676,9887347,2002,0.49492565471546496,0.5050743452845351
2411,The Guard,19561904,5360274,14201630,2011,0.27401596490811936,0.7259840350918806
2412,Puella Magi Madoka Magica the Movie Part III: The Rebellion Story,19544634,375627,19169007,2013,0.019218932418995412,0.9807810675810046
2413,View from the Top,19526014,15614000,3912014,2003,0.7996511730453537,0.20034882695464626
2414,Margin Call,19504039,5354039,14150000,2011,0.2745092439571106,0.7254907560428894
2415,In This Corner of the World,19496308,172147,19324161,2016,0.008829723042947414,0.9911702769570526
2416,The Lion King 2002 IMAX Release,19486215,15686215,3800000,2002,0.8049903483051993,0.19500965169480067
2417,2046,19470239,1444588,18025651,2004,0.0741946721866126,0.9258053278133874
2418,Blue Is the Warmest Colour,19465835,2199787,17266048,2013,0.11300758482746823,0.8869924151725318
2419,Vanity Fair,19463185,16136476,3326709,2004,0.8290768443088836,0.17092315569111632
2420,Buried,19439764,1044143,18395621,2010,0.05371171172654154,0.9462882882734585
2421,Get Carter,19412993,14967182,4445811,2000,0.7709878636436948,0.2290121363563053
2422,The Edge of Seventeen,19370020,14431633,4938387,2016,0.7450499792979047,0.2549500207020953
2423,Tuck Everlasting,19344615,19161999,182616,2002,0.9905598534786038,0.009440146521396265
2424,Rock Star,19334145,17008282,2325863,2001,0.8797017918299465,0.12029820817005354
2425,Duplex,19322135,9692135,9630000,2003,0.5016078709728505,0.4983921290271494
2426,Deep Blue,19288261,132261,19156000,2003,0.006857072288683775,0.9931429277113162
2427,The Lost City of Z,19263938,8580410,10683528,2017,0.44541308220572556,0.5545869177942745
2428,O,19260537,16025437,3235100,2001,0.8320347973683184,0.16796520263168155
2429,Half Past Dead,19233280,15567860,3665420,2002,0.809423041727672,0.19057695827232796
2430,Foxcatcher,19206513,12096300,7110213,2014,0.6298019843581185,0.3701980156418815
2431,Martin Lawrence Live: Runteldat,19184820,19184820,0,2002,1.0,0.0
2432,Everybody Knows,19176163,2660165,16515998,2018,0.13872248582784782,0.8612775141721521
2433,My Annoying Brother,19162324,51996,19110328,2016,0.0027134495794977685,0.9972865504205022
2434,They Shall Not Grow Old 2018 Re-release,19130011,17956913,1173098,2018,0.9386776097515052,0.06132239024849489
2435,Oolong Courtyard: KungFu School,19129015,37727,19091288,2018,0.0019722395533695804,0.9980277604466304
2436,The Weather Man,19126398,12482775,6643623,2005,0.6526464104741521,0.347353589525848
2437,Shame,19123767,3909002,15214765,2011,0.20440543957683652,0.7955945604231635
2438,Norwegian Wood,19115721,13000,19102721,2010,0.000680068515333531,0.9993199314846665
2439,Always Miss You,19015465,91884,18923581,2019,0.0048320669518205316,0.9951679330481795
2440,Memoir of a Murderer,19015346,91335,18924011,2017,0.004803225773541013,0.995196774226459
2441,Headhunters,18962444,1200010,17762434,2011,0.0632835092354129,0.9367164907645871
2442,The Man Who Wasn't There,18916623,7504257,11412366,2001,0.3967017263070687,0.6032982736929313
2443,The Curse of the Jade Scorpion,18914307,7517191,11397116,2001,0.3974341222229289,0.602565877777071
2444,Feardotcom,18902015,13258249,5643766,2002,0.7014198750768106,0.2985801249231894
2445,A Mighty Wind,18750246,17781006,969240,2003,0.948307878200638,0.051692121799361994
2446,Look at Me,18729751,1737308,16992443,2004,0.09275659884640218,0.9072434011535978
2447,3000 Miles to Graceland,18720175,15749959,2970216,2001,0.8413360986208729,0.15866390137912706
2448,Pina,18705853,3524826,15181027,2011,0.18843439002754914,0.8115656099724509
2449,13 Assassins,18689058,802778,17886280,2010,0.042954438902164035,0.957045561097836
2450,Glee: The 3D Concert Movie,18663238,11862398,6800840,2011,0.6356023536751768,0.3643976463248232
2451,The Drop,18658381,10724389,7933992,2014,0.5747759679684963,0.4252240320315037
2452,Greta,18653107,10532219,8120888,2019,0.56463617562479,0.43536382437521
2453,Peppa Celebrates Chinese New Year,18653040,131225,18521815,2019,0.0070350462980833155,0.9929649537019167
2454,Waiting...,18637690,16124543,2513147,2005,0.8651578065736687,0.13484219342633127
2455,Admission,18637201,18007317,629884,2013,0.9662028649044457,0.03379713509555431
2456,Max Keeble's Big Move,18634654,17294293,1340361,2001,0.9280715917773413,0.07192840822265871
2457,An Unfinished Life,18618284,8586392,10031892,2005,0.46118063297347917,0.5388193670265208
2458,De-Lovely,18611951,13456633,5155318,2004,0.7230103388946167,0.2769896611053833
2459,Detective K: Secret of the Living Dead,18603476,104013,18499463,2018,0.005591051908793819,0.9944089480912062
2460,Battle of the Sexes,18598607,12638526,5960081,2017,0.6795415377076358,0.32045846229236413
2461,The Turning,18592736,15472775,3119961,2020,0.832194626976901,0.16780537302309892
2462,Empire,18591272,17600423,990849,2002,0.9467035391661205,0.05329646083387947
2463,Keeping Mum,18575768,1619466,16956302,2005,0.0871816443874622,0.9128183556125378
2464,Black Christmas,18529730,10429730,8100000,2019,0.5628646504833044,0.4371353495166956
2465,Airpocalypse,18491089,105678,18385411,2018,0.005715077137966293,0.9942849228620337
2466,My Baby's Daddy,18490423,17669317,821106,2004,0.955592903418164,0.044407096581835906
2467,Motherless Brooklyn,18477736,9277736,9200000,2019,0.5021035044553077,0.4978964955446923
2468,Repo Men,18409891,13794835,4615056,2010,0.7493164951384014,0.25068350486159857
2469,Loser,18404706,15618626,2786080,2000,0.848621325437092,0.151378674562908
2470,The Wasted Times,18345372,386540,17958832,2016,0.021070164180917127,0.9789298358190829
2471,Fabricated City,18307490,104874,18202616,2017,0.005728475066762292,0.9942715249332377
2472,Asura,18300843,175702,18125141,2016,0.009600759921277943,0.990399240078722
2473,The World's Fastest Indian,18297690,5128124,13169566,2005,0.28026073236567023,0.7197392676343298
2474,Chappaquiddick,18263470,17395520,867950,2018,0.9524761723812616,0.04752382761873839
2475,Antitrust,18195610,11328094,6867516,2001,0.6225729173135718,0.3774270826864282
2476,My Boss's Daughter,18191005,15550605,2640400,2003,0.8548513399891869,0.14514866001081303
2477,The Case for Christ,18175663,14682684,3492979,2017,0.8078210957146378,0.19217890428536225
2478,Sorry to Bother You,18170707,17493096,677611,2018,0.9627086056695537,0.03729139433044625
2479,Hell Fest,18159691,11107431,7052260,2018,0.6116530837446518,0.3883469162553482
2480,All the Pretty Horses,18133495,15540353,2593142,2000,0.8569971205219954,0.14300287947800466
2481,Dead Man Down,18074539,10895295,7179244,2013,0.6027979468798623,0.3972020531201377
2482,The Lighthouse,18063334,10867104,7196230,2019,0.6016111975784758,0.3983888024215242
2483,Blinded by the Light,18019198,11901145,6118053,2019,0.6604702939609188,0.3395297060390812
2484,The Country Bears,18012097,16990825,1021272,2002,0.9433007716980427,0.05669922830195729
2485,Quills,17989227,7065332,10923895,2000,0.3927535074186345,0.6072464925813655
2486,Kalank,17987034,2729336,15257698,2019,0.15173908049542797,0.848260919504572
2487,Dope,17986781,17506470,480311,2015,0.9732964447612944,0.02670355523870558
2488,Cantinflas,17966873,6382924,11583949,2014,0.3552607067462435,0.6447392932537566
2489,Night Watch 2005 Re-release,17939389,1502188,16437201,2005,0.08373685413700545,0.9162631458629945
2490,We Have a Pope,17877523,548115,17329408,2011,0.030659448739067487,0.9693405512609325
2491,The Old Man & the Gun,17860397,11277120,6583277,2018,0.6314036580485864,0.3685963419514135
2492,The Quiet Ones,17835162,8509867,9325295,2014,0.4771398768343119,0.5228601231656881
2493,Unforgettable,17768012,11368012,6400000,2017,0.6398021343074284,0.36019786569257156
2494,The Last Kiss,17720347,1048950,16671397,2002,0.05919466475458974,0.9408053352454102
2495,Joyeux Noel,17709155,1054361,16654794,2005,0.059537623336630124,0.9404623766633698
2496,The Children Act,17696794,547750,17149044,2018,0.03095193400567357,0.9690480659943265
2497,Regression,17671101,55039,17616062,2015,0.0031146333213759574,0.996885366678624
2498,Before I Go to Sleep,17669776,3242457,14427319,2014,0.18350300535784947,0.8164969946421505
2499,Neerja,17618280,1585687,16032593,2015,0.09000237253579804,0.909997627464202
2500,Operation Finale,17612099,17612099,0,2018,1.0,0.0
2501,Deliver Us from Eva,17573594,17573594,0,2003,1.0,0.0
2502,Little Boy,17572289,6485961,11086328,2015,0.3691016577293943,0.6308983422706057
2503,Toilet: A Love Story,17567417,1830715,15736702,2017,0.10421082393615408,0.8957891760638459
2504,Loving Pablo,17535962,22017,17513945,2018,0.0012555341988081407,0.9987444658011918
2505,Addicted,17534314,17390770,143544,2014,0.9918135377295056,0.0081864622704943
2506,Roll Bounce,17500866,17380866,120000,2005,0.9931431964566781,0.006856803543321799
2507,Machete Kills,17496820,8008161,9488659,2013,0.45769236924195367,0.5423076307580463
2508,Rebound,17492014,16809014,683000,2005,0.9609536100302687,0.03904638996973133
2509,A Guy Thing,17432163,15545431,1886732,2003,0.8917671891893163,0.10823281081068367
2510,Frailty,17423030,13110448,4312582,2002,0.7524780706914929,0.2475219293085072
2511,Fate/Stay Night: Heaven's Feel - I. Presage Flower,17422935,193833,17229102,2017,0.011125163469874622,0.9888748365301254
2512,Stolen,17415418,304318,17111100,2012,0.017474056608919753,0.9825259433910802
2513,Kapoor & Sons,17412627,2607036,14805591,2016,0.14972100418851217,0.8502789958114878
2514,Billy and Buddy,17400053,894,17399159,2013,5.1379153845106106e-05,0.9999486208461549
2515,Fruitvale Station,17385830,16101339,1284491,2013,0.9261185114544431,0.07388148854555693
2516,The Matador,17347231,12594698,4752533,2005,0.7260350657692862,0.27396493423071383
2517,Fate/stay night [Heaven's Feel] II. lost butterfly,17295864,420595,16875269,2019,0.024317663459888447,0.9756823365401116
2518,The Importance of Being Earnest,17290970,8384929,8906041,2002,0.4849310940913089,0.515068905908691
2519,While We're Young,17287309,7587485,9699824,2015,0.4389049215236449,0.5610950784763551
2520,Legend of the Naga Pearls,17274695,13588,17261107,2017,0.0007865840757246365,0.9992134159242754
2521,My Afternoons with Margueritte,17107143,666557,16440586,2010,0.03896366564539736,0.9610363343546027
2522,Kinsey,17050017,10254979,6795038,2004,0.6014644442876509,0.39853555571234917
2523,Melancholia,17039814,3030848,14008966,2011,0.17786860819020678,0.8221313918097932
2524,Beyond Outrage,17027515,3878,17023637,2012,0.0002277490285576022,0.9997722509714424
2525,Kung Pow: Enter the Fist,16994625,16037962,956663,2002,0.9437079076472709,0.056292092352729174
2526,Chinese Puzzle,16968297,338523,16629774,2013,0.019950322651707476,0.9800496773482925
2527,Jason X,16951798,13121555,3830243,2001,0.7740509295828089,0.22594907041719114
2528,Catch That Kid,16951702,16703799,247903,2004,0.9853759227244556,0.014624077275544368
2529,The Nutcracker in 3D,16918946,195459,16723487,2010,0.011552670006748648,0.9884473299932514
2530,Sugar & Spice,16908947,13305101,3603846,2001,0.7868675086627216,0.21313249133727843
2531,Calvary,16887741,3600006,13287735,2014,0.21317273873397277,0.7868272612660272
2532,Life or Something Like It,16872671,14448589,2424082,2002,0.8563308678276249,0.1436691321723751
2533,The Last Godfather,16863629,164247,16699382,2010,0.009739718538637206,0.9902602814613628
2534,The Cold Light of Day,16863583,3763583,13100000,2012,0.2231781348008902,0.7768218651991098
2535,The Pyramid,16861137,2756333,14104804,2014,0.16347254636505237,0.8365274536349476
2536,The Good Girl,16856124,14018296,2837828,2002,0.8316440956414417,0.16835590435855835
2537,Monkey Kingdom,16839663,16432322,407341,2015,0.9758106204381881,0.024189379561811896
2538,Femme Fatale,16838910,6630252,10208658,2002,0.3937459134825235,0.6062540865174765
2539,House of 1000 Corpses,16829545,12634962,4194583,2003,0.7507607603176437,0.24923923968235623
2540,Hit and Run,16816647,13749300,3067347,2012,0.8176005597310807,0.18239944026891924
2541,Hardcore Henry,16810562,9252038,7558524,2016,0.5503705349053768,0.44962946509462326
2542,Paparazzi,16796512,15714234,1082278,2004,0.9355653126077604,0.06443468739223954
2543,The Birth of a Nation,16779212,15861566,917646,2016,0.9453105425928225,0.05468945740717741
2544,House of Sand and Fog,16763804,13040288,3723516,2003,0.7778835877584825,0.22211641224151749
2545,102 Not Out,16758596,1343797,15414799,2018,0.08018553582889641,0.9198144641711036
2546,Love Is All You Need,16722143,1631709,15090434,2012,0.09757774467064419,0.9024222553293558
2547,Delhi Belly,16706074,1532594,15173480,2011,0.09173872927894369,0.9082612707210563
2548,Pride,16699029,1446634,15252395,2014,0.08662982739894637,0.9133701726010536
2549,Dogville,16680836,1535286,15145550,2003,0.0920389121984054,0.9079610878015946
2550,CyberWorld,16653900,11253900,5400000,2000,0.6757516257453209,0.32424837425467906
2551,My Way,16653488,70177,16583311,2011,0.004213952056169854,0.9957860479438302
2552,Digimon: The Movie,16643191,9631153,7012038,2000,0.5786842799556888,0.4213157200443112
2553,Beautiful Boy,16636604,7649973,8986631,2018,0.45982779899070747,0.5401722010092925
2554,Nothing to Lose 2,16610713,1150551,15460162,2019,0.06926559985715243,0.9307344001428476
2555,Belle,16607575,10726630,5880945,2014,0.6458877951778029,0.3541122048221971
2556,Upgrade,16593554,11977130,4616424,2018,0.7217941376512832,0.27820586234871686
2557,The Dish,16575074,2552992,14022082,2000,0.1540259790092038,0.8459740209907962
2558,Tazza: One-Eyed Jack,16572611,97655,16474956,2019,0.005892553683906537,0.9941074463160935
2559,Battle of the Year,16549477,8888355,7661122,2013,0.5370776973798024,0.4629223026201976
2560,"Tomorrow, When the War Began",16533595,4936,16528659,2010,0.00029854366216179845,0.9997014563378382
2561,Silent House,16527747,12754783,3772964,2012,0.7717194001094039,0.2282805998905961
2562,Pride and Prejudice and Zombies,16457494,10938134,5519360,2016,0.6646293779599738,0.33537062204002627
2563,They,16446271,12840842,3605429,2002,0.7807752894257914,0.2192247105742086
2564,The Powerpuff Girls Movie,16426471,11412414,5014057,2002,0.6947575045181646,0.3052424954818354
2565,Poms,16418218,13631124,2787094,2019,0.8302438181780751,0.1697561818219249
2566,Forever My Girl,16376066,16376066,0,2018,1.0,0.0
2567,Before I Fall,16373843,12241122,4132721,2017,0.7476022580648904,0.25239774193510955
2568,The Magdalene Sisters,16373112,306989,16066123,2002,0.018749581631152343,0.9812504183688476
2569,The Single Moms Club,16365451,15973881,391570,2014,0.9760733755519478,0.02392662444805218
2570,Little Q,16360233,1652,16358581,2019,0.0001009765569964682,0.9998990234430035
2571,Italian for Beginners,16349568,4544753,11804815,2000,0.27797388897370257,0.7220261110262974
2572,Playmobil: The Movie,16349303,1115008,15234295,2019,0.068199115277269,0.931800884722731
2573,Macbeth,16322067,1110707,15211360,2015,0.06804940820301743,0.9319505917969826
2574,The Emperor's Club,16318449,14118751,2199698,2002,0.865201772545908,0.13479822745409198
2575,Rabbit-Proof Fence,16217411,6199600,10017811,2002,0.38228050087649623,0.6177194991235038
2576,Caché,16197824,3647381,12550443,2005,0.22517722133540902,0.774822778664591
2577,Gangnam 1970,16191434,18022,16173412,2015,0.0011130576822287637,0.9988869423177712
2578,In the House,16190771,389757,15801014,2012,0.024072788133437252,0.9759272118665627
2579,Just Visiting,16176732,4781539,11395193,2001,0.2955812706793931,0.7044187293206069
2580,Birthday Girl,16171098,5142576,11028522,2002,0.31801031692467635,0.6819896830753236
2581,Iris,16153953,5594617,10559336,2001,0.3463311426002044,0.6536688573997956
2582,Scouts Guide to the Zombie Apocalypse,16137046,3703046,12434000,2015,0.22947483696830262,0.7705251630316974
2583,The Space Between Us,16080475,7885294,8195181,2017,0.4903644948299102,0.5096355051700898
2584,To Be and to Have,16063920,777129,15286791,2002,0.04837729520565341,0.9516227047943466
2585,Unfriended: Dark Web,16024987,8866745,7158242,2018,0.5533074691417846,0.44669253085821536
2586,Sea Rex 3D: Journey to a Prehistoric World,16004150,6096582,9907568,2010,0.38093756931795814,0.6190624306820418
2587,What the #$*! Do We (K)now!?,15998178,10942306,5055872,2004,0.6839720123129022,0.3160279876870979
2588,The Kitchen,15980032,12180032,3800000,2019,0.762203229630579,0.23779677036942104
2589,The Words,15950164,11494838,4455326,2012,0.7206720883873043,0.27932791161269566
2590,Before Sunset,15936507,5820649,10115858,2004,0.3652399487541404,0.6347600512458595
2591,Drowning Mona,15906764,15506764,400000,2000,0.974853464853065,0.025146535146934976
2592,Wonder Wheel,15889124,1404061,14485063,2017,0.08836616795236792,0.911633832047632
2593,Finding Your Feet,15845593,1418682,14426911,2018,0.08953164453990456,0.9104683554600954
2594,Highlander: Endgame,15843608,12811858,3031750,2000,0.8086452277789251,0.1913547722210749
2595,The Hunt,15812352,613308,15199044,2012,0.03878663971052504,0.961213360289475
2596,"I, Daniel Blake",15793051,260354,15532697,2016,0.01648535169043651,0.9835146483095635
2597,The Great Yokai War,15787492,0,15787492,2005,0.0,1.0
2598,Kiss Kiss Bang Bang,15785148,4243756,11541392,2005,0.26884486607284264,0.7311551339271574
2599,The Gospel,15778152,15778152,0,2005,1.0,0.0
2600,Lantana,15747450,4623189,11124261,2001,0.2935833420649058,0.7064166579350942
2601,I Hate Luv Storys,15719212,847993,14871219,2010,0.053946279240969584,0.9460537207590304
2602,The Brand New Testament,15709652,127910,15581742,2015,0.008142128164264873,0.9918578718357351
2603,Enigma 2001 Re-release,15705007,4301582,11403425,2001,0.27389876362360105,0.7261012363763989
2604,Feng Shui,15702302,64147,15638155,2018,0.004085197189558576,0.9959148028104414
2605,Judy Moody and the Not Bummer Summer,15691640,15013650,677990,2011,0.956792916482917,0.04320708351708298
2606,Out of the Furnace,15660668,11330849,4329819,2013,0.723522713079672,0.276477286920328
2607,Vampire Academy,15642346,7791979,7850367,2014,0.4981336559106927,0.5018663440893073
2608,Tully,15636462,9369755,6266707,2018,0.5992247479001324,0.4007752520998676
2609,The Conspirator,15623183,11538204,4084979,2011,0.7385309382857513,0.2614690617142486
2610,Facing Windows,15530077,543354,14986723,2003,0.03498720579427906,0.965012794205721
2611,Paranoia,15500644,7388654,8111990,2013,0.47666755007082284,0.5233324499291772
2612,With a Friend Like Harry...,15472186,3830441,11641745,2001,0.24756947725421605,0.7524305227457839
2613,Bait,15471969,15325127,146842,2000,0.9905091588536663,0.009490841146333735
2614,Zelary,15461305,330033,15131272,2003,0.02134574022050532,0.9786542597794947
2615,Chronicles of Evil,15460494,105057,15355437,2015,0.006795190373606432,0.9932048096263936
2616,The Greatest Game Ever Played,15431177,15337393,93784,2005,0.9939224337845389,0.006077566215461076
2617,Our Little Sister,15407615,64441,15343174,2015,0.004182412398025262,0.9958175876019747
2618,Anonymous,15395087,4463292,10931795,2011,0.2899166467847827,0.7100833532152173
2619,Miss Bala,15383580,15006824,376756,2019,0.9755092117699521,0.024490788230047883
2620,Alex & Emma,15368897,14218698,1150199,2003,0.9251606019612207,0.07483939803877923
2621,Apollo 11,15342353,9039891,6302462,2019,0.5892115114285273,0.4107884885714727
2622,The Dead Don't Die,15321451,6563605,8757846,2019,0.4283931724221159,0.5716068275778841
2623,Brother,15250594,450594,14800000,2001,0.029545996700194106,0.9704540032998059
2624,Hey Arnold! The Movie,15249308,13728902,1520406,2002,0.9002967216610748,0.09970327833892528
2625,The Negotiation,15229193,110986,15118207,2018,0.0072877138007247004,0.9927122861992753
2626,Attack on Titan Part 2,15186410,305934,14880476,2015,0.020145248284485932,0.9798547517155141
2627,Spectacle,15159762,2065487,13094275,2015,0.13624798331266677,0.8637520166873333
2628,Transamerica,15151744,9015303,6136441,2005,0.5950010111047283,0.40499898889527175
2629,Extraordinary Measures,15134293,12068313,3065980,2010,0.7974150493848638,0.2025849506151361
2630,Irreplaceable,15130912,8494,15122418,2016,0.0005613673518159382,0.9994386326481841
2631,Surviving Christmas,15125687,11663156,3462531,2004,0.7710827283415292,0.22891727165847078
2632,Three,15121228,119550,15001678,2016,0.007906103922247585,0.9920938960777524
2633,The Dreamers,15121165,2532228,12588937,2003,0.1674624937959476,0.8325375062040524
2634,War of the Buttons,15082409,47771,15034638,2011,0.003167332221265184,0.9968326677787348
2635,Ip Man 2,15061802,205675,14856127,2010,0.013655404579080245,0.9863445954209198
2636,The Housemaid,15038301,157961,14880340,2010,0.01050391264279123,0.9894960873572087
2637,Boat Trip,15020293,8600126,6420167,2002,0.5725671263536604,0.42743287364633964
2638,Journey to the South Pacific,14994876,7653913,7340963,2013,0.510435231341693,0.489564768658307
2639,Oldboy,14980005,707481,14272524,2003,0.0472283553977452,0.9527716446022548
2640,Undisputed,14946150,12764657,2181493,2002,0.8540431482354988,0.14595685176450124
2641,Harry Potter and the Deathly Hallows: Part 2 2018 Re-release,14895840,181938,14713902,2018,0.01221401411400767,0.9877859858859923
2642,Blue Valentine,14892418,9706328,5186090,2010,0.651763064936802,0.3482369350631979
2643,Gold,14880939,7227038,7653901,2017,0.4856573903031254,0.5143426096968746
2644,School of Life,14880497,6300,14874197,2017,0.00042337295588984697,0.9995766270441101
2645,Raise Your Voice,14867514,10411980,4455534,2004,0.7003174841469798,0.2996825158530202
2646,Josie and the Pussycats,14866015,14271015,595000,2001,0.9599758240523771,0.040024175947622816
2647,Emperor,14858240,3346265,11511975,2013,0.22521274390506546,0.7747872560949345
2648,The Take,14857808,50269,14807539,2016,0.0033833389151347224,0.9966166610848652
2649,Supernova,14828081,14230455,597626,2000,0.9596963356215817,0.040303664378418216
2650,Soul Plane,14821824,14190750,631074,2004,0.9574226491962123,0.04257735080378771
2651,Possession,14815898,10113733,4702165,2002,0.6826270672219801,0.3173729327780199
2652,Somewhere,14788642,1785645,13002997,2010,0.12074435232119352,0.8792556476788065
2653,Out Cold,14782676,13906394,876282,2001,0.940722369887563,0.059277630112437016
2654,Seondal: The Man Who Sells the River,14777982,97477,14680505,2016,0.006596096814842514,0.9934039031851575
2655,The Triplets of Belleville,14776760,7007149,7769611,2003,0.47420063667542817,0.5257993633245718
2656,A Royal Affair,14758997,1546761,13212236,2012,0.10480122734627563,0.8951987726537244
2657,Sword Master,14714624,75526,14639098,2016,0.005132716948798691,0.9948672830512013
2658,Inherent Vice,14710975,8110975,6600000,2014,0.5513553656368799,0.4486446343631201
2659,Iron Monkey,14694904,14694904,0,2001,1.0,0.0
2660,The Way Back,14690514,13590514,1100000,2020,0.9251217486331655,0.0748782513668344
2661,Together with You,14687167,1151941,13535226,2003,0.07843180376447002,0.92156819623553
2662,"Hello, My Name Is Doris",14659448,14444999,214449,2016,0.985371277281382,0.014628722718618054
2663,Beyond the Lights,14618727,14618727,0,2014,1.0,0.0
2664,Welcome to Mooseport,14615099,14470947,144152,2004,0.9901367756728846,0.009863224327115403
2665,Together,14572229,1034829,13537400,2001,0.07101377558642538,0.9289862244135746
2666,Hollywood Ending,14569744,4850753,9718991,2002,0.33293330342660793,0.6670666965733921
2667,Megan Leavey,14510490,13406883,1103607,2017,0.9239441948548947,0.07605580514510536
2668,Envy,14494036,13562325,931711,2004,0.9357176289613189,0.06428237103868101
2669,Malena,14493284,3448233,11045051,2000,0.23791937010273173,0.7620806298972683
2670,A United Kingdom,14459330,3902185,10557145,2016,0.269873154565253,0.7301268454347469
2671,Serenity,14454622,8547045,5907577,2019,0.5913018687033117,0.40869813129668836
2672,America: Imagine the World Without Her,14444502,14444502,0,2014,1.0,0.0
2673,RBG,14441292,14017361,423931,2018,0.9706445240495103,0.02935547595048975
2674,Unfinished Business,14431253,10219501,4211752,2015,0.7081506366772171,0.29184936332278283
2675,45 Years,14430249,4247285,10182964,2015,0.2943320659262359,0.705667934073764
2676,Do You Believe?,14410698,12985600,1425098,2015,0.9011083293814082,0.09889167061859183
2677,Woodlawn,14401617,14394097,7520,2015,0.9994778364123973,0.0005221635876026977
2678,I Dreamed of Africa,14400327,6651522,7748805,2000,0.4619007610035522,0.5380992389964477
2679,How to Deal,14390329,14195227,195102,2003,0.986442144581962,0.013557855418038044
2680,Eighth Grade,14347433,13539709,807724,2018,0.9437025424687469,0.056297457531253155
2681,Thugs of Hindostan,14341431,1449848,12891583,2018,0.1010950720329094,0.8989049279670905
2682,Being Julia,14339171,7739049,6600122,2004,0.5397138370133113,0.4602861629866887
2683,Freddy Got Fingered,14333252,14254993,78259,2001,0.9945400387853364,0.005459961214663637
2684,The Other Side of the Door,14332467,3000342,11332125,2016,0.20933883887540086,0.7906611611245992
2685,Beginners,14311701,5790894,8520807,2011,0.4046265360071455,0.5953734639928545
2686,The Beauty Inside,14301869,108083,14193786,2015,0.007557264019129248,0.9924427359808707
2687,Unsane,14293601,7732899,6560702,2018,0.5410042577794077,0.45899574222059225
2688,Stealing Harvard,14277032,14036406,240626,2002,0.9831459367745341,0.01685406322546591
2689,Colette,14273033,5137622,9135411,2018,0.35995306673781247,0.6400469332621875
2690,Proof,14189860,7535331,6654529,2005,0.5310363174830478,0.46896368251695225
2691,What Planet Are You From?,14145677,6291602,7854075,2000,0.4447720671128006,0.5552279328871994
2692,Ya veremos,14134723,4165949,9968774,2018,0.2947315628328903,0.7052684371671096
2693,Shaandaar,14120808,521794,13599014,2015,0.03695213475036273,0.9630478652496373
2694,Red Lights,14107313,52624,14054689,2012,0.0037302638709440982,0.9962697361290559
2695,Seeking Justice,14089528,411746,13677782,2011,0.02922354815576505,0.970776451844235
2696,Island of Lemurs: Madagascar,14066534,11272213,2794321,2014,0.8013497141513325,0.19865028584866748
2697,Osmosis Jones,14026418,13596911,429507,2001,0.9693787109438775,0.030621289056122526
2698,Ghosts of Mars,14010832,8709640,5301192,2001,0.621636174068749,0.3783638259312509
2699,Dirty Pretty Things,13904766,8112414,5792352,2002,0.5834268624153761,0.4165731375846239
2700,Touching the Void,13885802,4593598,9292204,2003,0.33081258108102074,0.6691874189189793
2701,The Quake,13837294,6235,13831059,2018,0.0004505938805665327,0.9995494061194334
2702,House of the Dead,13818181,10249719,3568462,2003,0.7417560241829225,0.25824397581707753
2703,Juwanna Mann,13802599,13670733,131866,2002,0.9904462920352899,0.009553707964710124
2704,Back To The Future Day,13801197,1650000,12151197,2015,0.1195548473078096,0.8804451526921904
2705,Winter's Bone,13796834,6531503,7265331,2010,0.47340592776574686,0.5265940722342531
2706,La Belle Époque,13770064,0,13770064,2020,0.0,1.0
2707,The Ladies Man,13743212,13616610,126602,2000,0.9907880341218632,0.009211965878136785
2708,Pulling Strings,13725819,5842961,7882858,2013,0.4256912465478381,0.5743087534521619
2709,American Outlaws,13678913,13342790,336123,2001,0.9754276527674385,0.024572347232561534
2710,Phantom,13676590,489984,13186606,2015,0.03582647428927825,0.9641735257107218
2711,All Is Lost,13627519,6263670,7363849,2013,0.45963392162579264,0.5403660783742074
2712,Sing Street,13624522,3237118,10387404,2016,0.23759497764398635,0.7624050223560137
2713,Do It Like An Hombre,13610252,2534252,11076000,2017,0.18620169560416663,0.8137983043958333
2714,Love Forecast,13608637,32211,13576426,2015,0.0023669526933520232,0.9976330473066479
2715,Strange Magic,13603453,12429583,1173870,2015,0.9137079387123255,0.08629206128767454
2716,Anything Else,13585075,3212310,10372765,2003,0.23645876080919687,0.7635412391908032
2717,The Two Faces of January,13551951,507463,13044488,2014,0.03744575227581623,0.9625542477241837
2718,Nymphomaniac: Vol. I,13545832,785896,12759936,2013,0.05801755108139537,0.9419824489186046
2719,Phantom of the Theatre,13526843,43955,13482888,2016,0.0032494647864250363,0.9967505352135749
2720,The Man,13485145,8330720,5154425,2005,0.6177701463350969,0.38222985366490314
2721,One Night at McCool's,13473370,6290673,7182697,2001,0.46689677489744585,0.5331032251025541
2722,The Lord of the Rings: The Two Towers 2003 Re-release,13451150,1996877,11454273,2003,0.1484539983570178,0.8515460016429822
2723,Three Identical Strangers,13448497,12320845,1127652,2018,0.9161503326356841,0.08384966736431587
2724,Trapped,13414416,7073251,6341165,2002,0.5272872855590582,0.47271271444094176
2725,Lords of Dogtown,13411957,11273517,2138440,2005,0.8405571983268363,0.15944280167316374
2726,The Third Murder,13411936,89315,13322621,2017,0.006659366701421778,0.9933406332985782
2727,Solarmax,13400161,13400161,0,2000,1.0,0.0
2728,Our President,13392049,507268,12884781,2017,0.03787829629356942,0.9621217037064306
2729,Ratchet & Clank,13385737,8821329,4564408,2016,0.6590095860989947,0.3409904139010052
2730,RRRrrrr!!!,13315054,54361,13260693,2004,0.004082672139369469,0.9959173278606306
2731,Hotel Artemis,13313581,6708147,6605434,2018,0.5038574520258674,0.4961425479741326
2732,Vera Drake,13267869,3775283,9492586,2004,0.2845432827230959,0.7154567172769041
2733,Paris Can Wait,13203541,5617731,7585810,2017,0.42547154585273755,0.5745284541472625
2734,Kal ho naa ho,13200241,1991922,11208319,2003,0.15090042674220872,0.8490995732577913
2735,The Well Digger's Daughter,13194167,386368,12807799,2011,0.029283243117962657,0.9707167568820373
2736,The Honeymooners,13183426,12843849,339577,2005,0.9742421279567238,0.025757872043276155
2737,Mommy,13156856,3494070,9662786,2014,0.2655702851805933,0.7344297148194067
2738,The Sisters Brothers,13143056,3143056,10000000,2018,0.23914194689576002,0.76085805310424
2739,Head Over Heels,13127022,10424470,2702552,2001,0.7941229930139524,0.20587700698604755
2740,The Crew,13105853,13023075,82778,2000,0.9936838907013531,0.006316109298646948
2741,Hillary's America: The Secret History of the Democratic Party,13099931,13099931,0,2016,1.0,0.0
2742,The Angels' Share,13090471,346669,12743802,2012,0.026482545967979304,0.9735174540320207
2743,Shut In,13082071,6900335,6181736,2016,0.5274650321038619,0.47253496789613814
2744,Hot Tub Time Machine 2,13081651,12314651,767000,2015,0.94136825695778,0.05863174304221998
2745,The Way of the Gun,13069740,6055661,7014079,2000,0.4633344657200526,0.5366655342799475
2746,The Barbarian Invasions,13065317,5109226,7956091,2003,0.39105258601838744,0.6089474139816126
2747,Welcome to Marwen,13061491,10763520,2297971,2018,0.8240651852074162,0.1759348147925838
2748,"Roman J. Israel, Esq.",13025860,11962778,1063082,2017,0.9183868090091556,0.08161319099084437
2749,Friends with Kids,13019073,7251073,5768000,2012,0.5569577035169861,0.4430422964830138
2750,The Vatican Tapes,13015764,1784763,11231001,2015,0.13712318385613015,0.8628768161438698
2751,In a Better World,13004504,1008098,11996406,2010,0.07751914259859508,0.922480857401405
2752,The Divorce,12991996,9081057,3910939,2003,0.6989731985754922,0.30102680142450783
2753,Pyaar Ka Punchnama 2,12983721,222856,12760865,2015,0.017164262848839713,0.9828357371511602
2754,The Wave,12975143,177404,12797739,2015,0.013672604610215086,0.9863273953897849
2755,I Saw the Devil,12966357,129210,12837147,2010,0.00996501947308716,0.9900349805269129
2756,Le Havre,12959706,611709,12347997,2011,0.04720083927829844,0.9527991607217016
2757,Loving,12957265,7751969,5205296,2016,0.5982720118790501,0.4017279881209499
2758,Child 44,12951093,1224330,11726763,2015,0.09453487825313277,0.9054651217468672
2759,Godzilla 2000,12924063,10037390,2886673,2000,0.7766435369434519,0.22335646305654808
2760,Gods and Generals,12923936,12882934,41002,2003,0.9968274370903725,0.0031725629096275316
2761,Take Point,12908032,112386,12795646,2018,0.008706671938836221,0.9912933280611638
2762,Mubarakan,12899968,758868,12141100,2017,0.05882712267193221,0.9411728773280678
2763,Formula 51,12881605,5204007,7677598,2001,0.4039874689528207,0.5960125310471793
2764,In the Mood for Love,12854953,2738980,10115973,2000,0.21306806800460493,0.7869319319953951
2765,Earth: One Amazing Day,12851540,81345,12770195,2017,0.006329591628707532,0.9936704083712925
2766,The Girl from Paris,12812396,183266,12629130,2001,0.014303803909901006,0.985696196090099
2767,Knockaround Guys,12806614,11715637,1090977,2002,0.9148114404010302,0.08518855959896972
2768,Aliens of the Deep,12770637,8968684,3801953,2005,0.7022894785906137,0.29771052140938625
2769,Suburbicon,12751667,5775178,6976489,2017,0.4528959233330042,0.5471040766669958
2770,Elle,12748594,2341534,10407060,2016,0.18366997960716294,0.8163300203928371
2771,Populaire,12698385,179091,12519294,2012,0.014103447013143797,0.9858965529868562
2772,The Past,12673462,1331747,11341715,2013,0.10508154756766541,0.8949184524323346
2773,"Remember Me, My Love",12671306,227986,12443320,2003,0.01799230481846149,0.9820076951815385
2774,Redemption,12671109,36895,12634214,2013,0.0029117419793326695,0.9970882580206674
2775,The Green Inferno,12666449,7192291,5474158,2015,0.5678222049447323,0.43217779505526766
2776,Chasing Papi,12661189,6130049,6531140,2003,0.4841606108241493,0.5158393891758507
2777,Winged Migration 2003 Re-release,12634963,10764402,1870561,2003,0.8519535830852849,0.14804641691471515
2778,Narc,12633747,10465659,2168088,2002,0.8283891548564333,0.17161084514356667
2779,Made in Dagenham,12629471,1095369,11534102,2010,0.08673118612806506,0.9132688138719349
2780,Luis and the Aliens,12627729,169710,12458019,2018,0.013439471182823135,0.9865605288171768
2781,Politics,12604224,1514558,11089666,2010,0.12016273274737103,0.879837267252629
2782,Their Finest,12597262,3603484,8993778,2017,0.2860529534116223,0.7139470465883777
2783,Maria Full of Grace,12594630,6529624,6065006,2004,0.5184450833410748,0.48155491665892525
2784,Gossip,12591270,5108820,7482450,2000,0.4057430267161295,0.5942569732838705
2785,People Like Us,12558931,12434778,124153,2012,0.9901143656255457,0.009885634374454322
2786,Breakin' All the Rules,12544254,12264319,279935,2004,0.9776842050551591,0.022315794944840883
2787,Apocalypse Now Redux 2001 Re-release,12543269,4626290,7916979,2001,0.36882649969477654,0.6311735003052235
2788,The Clearing,12520799,5763875,6756924,2004,0.46034402437096866,0.5396559756290313
2789,Sorority Boys,12517488,10200032,2317456,2002,0.8148625347194262,0.18513746528057387
2790,Seducing Doctor Lewis,12504038,9354342,3149696,2003,0.7481056919372766,0.2518943080627234
2791,Ready to Rumble,12452362,12394327,58035,2000,0.9953394384133709,0.004660561586629107
2792,The Promise,12448676,8224288,4224388,2017,0.6606556392021128,0.33934436079788727
2793,Can You Ever Forgive Me?,12442161,8803865,3638296,2018,0.707583272712835,0.292416727287165
2794,Nine Queens,12413888,1222889,11190999,2002,0.09850974972546876,0.9014902502745312
2795,Monsieur Ibrahim,12364836,2823890,9540946,2003,0.22838070800130306,0.7716192919986969
2796,Rampant,12359573,167937,12191636,2018,0.013587605332320138,0.9864123946676798
2797,Tall Tales from the Magical Garden of Antoon Krings 2018 Re-release,12353849,220,12353629,2018,1.7808215075317822e-05,0.9999821917849246
2798,Casshern,12353768,0,12353768,2004,0.0,1.0
2799,Say It Isn't So,12320393,5520393,6800000,2001,0.4480695542747703,0.5519304457252298
2800,Chasing Liberty,12313323,12195626,117697,2004,0.990441491707803,0.009558508292196996
2801,Abandon,12302219,10727683,1574536,2002,0.8720120329511286,0.12798796704887141
2802,Marrowbone,12294931,1377,12293554,2017,0.00011199737517843735,0.9998880026248216
2803,The Beatles: Eight Days a Week - The Touring Years,12283800,2930414,9353386,2016,0.23855924062586495,0.761440759374135
2804,The Current War: Director's Cut,12282385,5979540,6302845,2019,0.4868386718051909,0.5131613281948091
2805,The Man Who Knew Infinity,12252684,3866794,8385890,2016,0.3155875071943421,0.684412492805658
2806,Gainsbourg: A Heroic Life,12220456,233007,11987449,2010,0.0190669644406068,0.9809330355593932
2807,The Guillotines,12217440,5290,12212150,2012,0.0004329875980565487,0.9995670124019435
2808,I Married an Anti-Fan,12194083,89408,12104675,2016,0.007332080649278835,0.9926679193507212
2809,Koi... Mil Gaya,12168232,671372,11496860,2003,0.05517416170237385,0.9448258382976261
2810,Little Women,12165890,1379497,10786393,2018,0.11339055342436928,0.8866094465756307
2811,The Eye,12165016,512049,11652967,2002,0.04209192984209803,0.957908070157902
2812,My Big Fat Independent Movie,12155249,4655,12150594,2005,0.0003829621260740936,0.9996170378739259
2813,Dark Blue,12150301,9250301,2900000,2003,0.7613227853367583,0.23867721466324168
2814,Miss & Mrs. Cops,12147170,104578,12042592,2019,0.008609248080005466,0.9913907519199945
2815,Bachelorette,12128575,447954,11680621,2012,0.03693377004305947,0.9630662299569406
2816,Barney's Version,12104765,4439201,7665564,2011,0.3667316961543657,0.6332683038456344
2817,Stoker,12077441,1714221,10363220,2012,0.14193577927642123,0.8580642207235788
2818,Don't Move,12071007,337265,11733742,2004,0.027940088179884248,0.9720599118201158
2819,The Connection,12062441,190980,11871461,2014,0.01583261630046522,0.9841673836995348
2820,The Bookshop,12055868,1588150,10467718,2017,0.13173253058178805,0.868267469418212
2821,Three Burials,12045362,5027684,7017678,2005,0.41739584082238457,0.5826041591776154
2822,Tamara Drewe,12037973,560391,11477582,2010,0.04655194026436178,0.9534480597356382
2823,I Am Love,12014663,5005465,7009198,2010,0.4166130169443787,0.5833869830556213
2824,The Cookout,12009070,11814019,195051,2004,0.9837580262251782,0.016241973774821863
2825,A Most Violent Year,12007070,5749134,6257936,2014,0.47881239969451334,0.5211876003054867
2826,The Assassin,11991669,632542,11359127,2015,0.052748453947486375,0.9472515460525136
2827,This Must Be the Place,11928909,143979,11784930,2011,0.012069754241565594,0.9879302457584344
2828,The Polar Express 2005 IMAX Release,11910480,10900597,1009883,2005,0.9152105540666707,0.08478944593332931
2829,The Warring States,11868961,68961,11800000,2011,0.005810196865589161,0.9941898031344109
2830,Viceroy's House,11868221,1105717,10762504,2017,0.09316619567498785,0.9068338043250121
2831,Boy Erased,11853081,6788692,5064389,2018,0.5727364893566491,0.4272635106433509
2832,Layer Cake,11850214,2339957,9510257,2004,0.1974611597731484,0.8025388402268516
2833,Unstoppable,11845347,101417,11743930,2018,0.008561758469380424,0.9914382415306195
2834,What Women Want,11838177,123526,11714651,2011,0.010434545791974559,0.9895654542080254
2835,Last Letter,11834622,180946,11653676,2018,0.015289546214488303,0.9847104537855117
2836,The Rules of Attraction,11819244,6532619,5286625,2002,0.5527103933212649,0.44728960667873513
2837,Ash Is Purest White,11813509,422814,11390695,2018,0.03579072060638376,0.9642092793936162
2838,Chloe,11808880,3075255,8733625,2010,0.2604188542859272,0.7395811457140729
2839,Getaway,11806432,10501938,1304494,2013,0.8895098874918349,0.11049011250816504
2840,Ballon,11799591,34222,11765369,2018,0.002900270017833669,0.9970997299821663
2841,The Divine Fury,11799556,102982,11696574,2019,0.0087276165306559,0.9912723834693441
2842,Win Win,11789613,10179275,1610338,2011,0.8634104444310429,0.1365895555689572
2843,Toni Erdmann,11784207,1479387,10304820,2016,0.12553980085380373,0.8744601991461962
2844,The Interview,11782625,6105175,5677450,2014,0.5181506667656826,0.4818493332343175
2845,Millions,11782282,6584159,5198123,2005,0.5588186566914627,0.44118134330853737
2846,The Son's Room,11767402,1016340,10751062,2001,0.08636910679179652,0.9136308932082035
2847,C'est Si Bon,11750035,164167,11585868,2015,0.013971617956882681,0.9860283820431173
2848,Beyond Borders,11705002,4430101,7274901,2003,0.3784793031218619,0.621520696878138
2849,Seeking a Friend for the End of the World,11681781,7078738,4603043,2012,0.6059639364922181,0.3940360635077819
2850,Shopgirl,11675161,10284523,1390638,2005,0.8808891800292946,0.11911081997070533
2851,A Sound of Thunder,11665465,1900451,9765014,2005,0.16291257999573955,0.8370874200042604
2852,Back to Burgundy,11625884,257610,11368274,2017,0.02215831501501305,0.9778416849849869
2853,The Lunchbox 2013 Re-release,11621581,4235151,7386430,2013,0.36442124354681177,0.6355787564531883
2854,Delicacy,11597420,498584,11098836,2011,0.042990941088621434,0.9570090589113786
2855,The Order,11560806,7660806,3900000,2002,0.6626532786727846,0.33734672132721544
2856,The Legend of Drunken Master,11555430,11555430,0,2000,1.0,0.0
2857,Haute Cuisine,11509942,217883,11292059,2012,0.01892998244474212,0.9810700175552579
2858,Fists of Legend,11478881,134213,11344668,2013,0.011692167555356658,0.9883078324446434
2859,Trumbo,11430025,7857741,3572284,2015,0.6874649005579603,0.3125350994420397
2860,Seasons,11425100,150092,11275008,2016,0.013137040376014214,0.9868629596239857
2861,Fun Size,11417362,9409538,2007824,2012,0.8241429149745799,0.17585708502542005
2862,Suspect Zero,11416075,8725813,2690262,2004,0.7643444003302361,0.2356555996697639
2863,Bring The Soul: The Movie,11393886,4809800,6584086,2019,0.42213868034136903,0.577861319658631
2864,The King's Case Note,11383493,90959,11292534,2017,0.007990429651074587,0.9920095703489255
2865,King of Thieves,11353515,7518,11345997,2018,0.0006621737849467764,0.9993378262150532
2866,Bajirao Mastani,11350917,6557047,4793870,2015,0.577666720671114,0.4223332793288859
2867,The Apparition,11350665,4936819,6413846,2012,0.4349365433655209,0.5650634566344791
2868,Snow Flower and the Secret Fan,11348205,1348205,10000000,2011,0.11880337022463024,0.8811966297753697
2869,Connie and Carla,11341016,8085771,3255245,2004,0.7129670745548723,0.28703292544512765
2870,Kabhi Khushi Kabhie Gham...,11329690,2902000,8427690,2001,0.2561411653805179,0.7438588346194821
2871,"It's Not You, It's Me",11301956,1339911,9962045,2010,0.11855567301801564,0.8814443269819844
2872,Tomorrow,11277905,62510,11215395,2015,0.00554269609470908,0.994457303905291
2873,At Eternity's Gate,11242604,2294915,8947689,2018,0.2041266418349343,0.7958733581650657
2874,You Can Count on Me,11242521,9416804,1825717,2000,0.8376060849697323,0.16239391503026768
2875,Straw Dogs,11168712,10324441,844271,2010,0.9244074876315191,0.0755925123684808
2876,Ida,11156836,3827060,7329776,2013,0.343023774840824,0.656976225159176
2877,Shadow of the Vampire,11155214,8293784,2861430,2000,0.7434894570377583,0.2565105429622417
2878,Gloria Bell,11145006,5611123,5533883,2019,0.5034652291797779,0.49653477082022207
2879,Bicycling with Molière,11123929,59874,11064055,2013,0.0053824507509891515,0.9946175492490108
2880,We Are Your Friends,11122090,3591417,7530673,2015,0.32290846414657676,0.6770915358534232
2881,Conviction 2010 Re-release,11104555,6783129,4321426,2010,0.6108420373441349,0.3891579626558651
2882,The Warrior's Way,11103434,5666340,5437094,2010,0.510323202713683,0.489676797286317
2883,The Squid and the Whale,11098131,7372734,3725397,2005,0.6643221277528621,0.33567787224713785
2884,The Belko Experiment,11084630,10166820,917810,2017,0.9171997621932352,0.08280023780676486
2885,Promised Land,11039031,7597898,3441133,2012,0.6882758097155448,0.3117241902844552
2886,Head-On,11030861,435395,10595466,2004,0.039470626998200774,0.9605293730017992
2887,Last Night,11027222,99000,10928222,2010,0.008977782436954657,0.9910222175630453
2888,La boda de Valentina,11021794,2783739,8238055,2018,0.2525667781488204,0.7474332218511796
2889,The Loft,11016443,6002684,5013759,2014,0.5448840428802655,0.45511595711973457
2890,Adrenaline Rush: The Science of Risk,11011932,10994028,17904,2002,0.9983741272648614,0.0016258727351385752
2891,Gringo,11001627,4969853,6031774,2018,0.4517380020246096,0.5482619979753903
2892,[REC] 3: Genesis,10998667,9600,10989067,2012,0.0008728330442225408,0.9991271669557774
2893,The Beat That My Heart Skipped,10988397,1023424,9964973,2005,0.09313678783174652,0.9068632121682535
2894,Hyde Park on Hudson,10980481,6376145,4604336,2012,0.5806799356057353,0.41932006439426467
2895,Justin Bieber's Believe,10980157,6206566,4773591,2013,0.5652529376401448,0.43474706235985516
2896,District B13,10976892,1200216,9776676,2004,0.10934023947762263,0.8906597605223774
2897,Friend Request,10975390,3759078,7216312,2016,0.3425006309570776,0.6574993690429224
2898,The Florida Project,10971298,5904366,5066932,2017,0.538164764096281,0.46183523590371894
2899,Extreme Ops,10959475,4842259,6117216,2002,0.441833117006061,0.558166882993939
2900,I Still Believe,10940855,9868521,1072334,2020,0.9019880987363419,0.0980119012636581
2901,Jonah Hex,10903312,10547117,356195,2010,0.9673314860658853,0.0326685139341147
2902,One Chance,10900434,101196,10799238,2013,0.009283667053990695,0.9907163329460094
2903,A Bag of Marbles,10898998,411318,10487680,2017,0.037739065554466565,0.9622609344455334
2904,The Perfect Score,10898337,10391003,507334,2004,0.9534484940225284,0.04655150597747161
2905,The Darkness,10898293,10753574,144719,2016,0.9867209479502891,0.013279052049710905
2906,Lucky Numbers,10890222,10042516,847706,2000,0.9221589789445982,0.0778410210554018
2907,Here on Earth,10873148,10522168,350980,2000,0.9677204798463149,0.03227952015368502
2908,Steamboy,10870198,468867,10401331,2004,0.043133252954545995,0.956866747045454
2909,Only You,10857889,61565,10796324,2015,0.005670070858156682,0.9943299291418434
2910,The Libertine,10852064,4835065,6016999,2005,0.44554335470192585,0.5544566452980741
2911,2.0,10847903,4152000,6695903,2018,0.38274678525425604,0.6172532147457439
2912,I'm Always Here,10836270,1747060,9089210,2004,0.16122337298719946,0.8387766270128005
2913,Danny Collins,10835752,5637066,5198686,2015,0.5202284068516887,0.47977159314831125
2914,Flying Monsters 3D with David Attenborough,10813862,5705874,5107988,2011,0.5276444252756324,0.4723555747243677
2915,Sophie Scholl: The Final Days,10804315,680331,10123984,2005,0.06296845288201983,0.9370315471179802
2916,Carandiru,10781635,216335,10565300,2004,0.02006513854345839,0.9799348614565416
2917,The Great Raid,10769311,10167373,601938,2005,0.9441061735518642,0.05589382644813582
2918,Golden Slumber,10733326,94450,10638876,2018,0.008799695453208073,0.991200304546792
2919,Our Kind of Traitor,10711027,3153157,7557870,2016,0.2943841893032293,0.7056158106967707
2920,Prom,10702246,10130219,572027,2011,0.9465507520570916,0.05344924794290843
2921,The Sessions,10656155,6002451,4653704,2012,0.563284880897472,0.4367151191025281
2922,Red Joan,10647493,1579730,9067763,2018,0.14836638070576802,0.851633619294232
2923,Only God Forgives,10635126,779188,9855938,2013,0.07326551655335348,0.9267344834466466
2924,My Old Lady,10606667,4013786,6592881,2014,0.37842104404710736,0.6215789559528927
2925,Heartbreaker 2010 Re-release,10606371,504030,10102341,2010,0.04752143782260681,0.9524785621773932
2926,First Daughter,10592180,9055921,1536259,2004,0.8549629065971311,0.1450370934028689
2927,Pollock,10558970,8598593,1960377,2000,0.814340129766445,0.18565987023355499
2928,The Phone,10551318,40516,10510802,2015,0.0038398994324690054,0.996160100567531
2929,Moms' Night Out,10536956,10429707,107249,2014,0.9898216334964292,0.01017836650357086
2930,Get Low,10522511,9176933,1345578,2010,0.8721238685329006,0.12787613146709945
2931,Anatomie,10501958,9660,10492298,2000,0.0009198284738902974,0.9990801715261097
2932,Intimate Strangers,10484574,2110589,8373985,2004,0.20130422084864869,0.7986957791513513
2933,The Leisure Seeker,10472180,3226443,7245737,2017,0.308096594978314,0.691903405021686
2934,The Cooler,10464788,8291572,2173216,2003,0.7923306234201782,0.2076693765798218
2935,Alone in the Dark,10442808,5178569,5264239,2005,0.49589813391187504,0.5041018660881249
2936,Mood Indigo,10435322,303187,10132135,2013,0.029053918987837653,0.9709460810121624
2937,Furious,10433259,9996,10423263,2017,0.0009580898931005164,0.9990419101068995
2938,Every Day,10421847,6102076,4319771,2018,0.5855081157879213,0.4144918842120787
2939,The Perfect Match,10414738,9669521,745217,2016,0.9284459196189093,0.07155408038109072
2940,The Virgin Suicides,10409377,4906229,5503148,2000,0.4713278229811448,0.5286721770188552
2941,Swing Kids,10397408,222001,10175407,2018,0.0213515714685814,0.9786484285314186
2942,Lobster Cop,10373129,85693,10287436,2018,0.008261056042010082,0.9917389439579899
2943,Town & Country,10372291,6719973,3652318,2001,0.6478774072189066,0.35212259278109337
2944,Queen of Katwe,10367161,8874389,1492772,2016,0.8560095671322168,0.14399043286778318
2945,Wasabi,10366360,97220,10269140,2001,0.009378412480369195,0.9906215875196308
2946,Kin,10313019,5718096,4594923,2018,0.5544541321993104,0.4455458678006896
2947,The Babadook,10312540,964413,9348127,2014,0.09351847362531442,0.9064815263746856
2948,3-D Sex and Zen: Extreme Ecstasy,10306807,153215,10153592,2011,0.014865418553000944,0.9851345814469991
2949,"Where'd You Go, Bernadette",10304189,9198356,1105833,2019,0.8926812192594682,0.10731878074053183
2950,Stone,10300416,1810078,8490338,2010,0.17572863076598072,0.8242713692340193
2951,Saved!,10275509,8940582,1334927,2004,0.8700865329396335,0.12991346706036655
2952,Girls vs Gangsters,10265819,37115,10228704,2018,0.0036153959075257416,0.9963846040924743
2953,Chennai Express,10234653,5307960,4926693,2013,0.5186262787805312,0.4813737212194688
2954,The Miracle Season,10230620,10230620,0,2018,1.0,0.0
2955,The Wash,10229331,10097538,131793,2001,0.9871161662478221,0.012883833752177928
2956,In the Mix,10223896,10223896,0,2005,1.0,0.0
2957,Babies,10219306,7320323,2898983,2010,0.7163229088159215,0.28367709118407847
2958,The Best of Enemies,10209813,10205616,4197,2019,0.9995889248902012,0.0004110751097987789
2959,Senna,10197661,1612430,8585231,2010,0.15811763109207103,0.841882368907929
2960,BTS World Tour: Love Yourself in Seoul,10195760,3509917,6685843,2019,0.34425261088923237,0.6557473891107676
2961,Woman on Top,10194274,5020111,5174163,2000,0.492444189748088,0.507555810251912
2962,For Greater Glory: The True Story of Cristiada,10173682,5672846,4500836,2012,0.557600090114867,0.44239990988513306
2963,The Ice Harvest,10156968,9016782,1140186,2005,0.8877434683263745,0.11225653167362544
2964,Sleepover,10143022,9436390,706632,2004,0.9303331886690179,0.06966681133098203
2965,Ben Is Back,10134204,3703184,6431020,2018,0.36541439268441805,0.634585607315582
2966,Thirteen,10128960,4601043,5527917,2003,0.4542463392095536,0.5457536607904464
2967,Trespass,10117966,24094,10093872,2011,0.00238130865432835,0.9976186913456716
2968,Marshall,10116816,10051659,65157,2017,0.9935595349366836,0.006440465063316364
2969,Iron Sky,10109659,122082,9987577,2012,0.012075778223578065,0.9879242217764219
2970,Bernie,10090641,9206470,884171,2012,0.9123771225237326,0.08762287747626736
2971,Pulse: A Stomp Odyssey,10086514,10086514,0,2002,1.0,0.0
2972,A Little Chaos,10084623,558173,9526450,2015,0.05534892082728328,0.9446510791727167
2973,Gladiators of Rome,10079201,8201,10071000,2012,0.000813655764975815,0.9991863442350242
2974,Papillon,10060903,2335896,7725007,2018,0.23217558105867833,0.7678244189413217
2975,A Day Without a Mexican,10057021,4179890,5877131,2004,0.4156190983393591,0.5843809016606408
2976,Sexy Beast,10045677,6946056,3099621,2001,0.6914472762761534,0.30855272372384657
2977,The Deep End,10031529,8823109,1208420,2001,0.8795378052538152,0.12046219474618475
2978,The King's Choice,10017316,113231,9904085,2016,0.01130352681297066,0.9886964731870294
2979,Kissing Jessica Stein,10013424,7025722,2987702,2002,0.7016303314430709,0.2983696685569292
2980,Elephant,10012022,1266955,8745067,2003,0.12654336956111362,0.8734566304388863
2981,Moonlight Mile,10011050,6835856,3175194,2002,0.6828310716658093,0.3171689283341907
2982,Thank You for Your Service,9995692,9536300,459392,2017,0.9540410008631719,0.045958999136828146
2983,Angel-A,9995168,202647,9792521,2005,0.02027449663677489,0.9797255033632251
2984,Alan Partridge,9979601,153426,9826175,2013,0.015373961343745106,0.9846260386562549
2985,Returner,9978256,73060,9905196,2002,0.007321920784553934,0.992678079215446
2986,Kinky Boots,9950133,1822428,8127705,2005,0.18315614474700992,0.8168438552529901
2987,Cyrus,9933873,7468936,2464937,2010,0.7518654607321837,0.24813453926781628
2988,The Goldfinch,9932621,5332621,4600000,2019,0.5368795406569927,0.4631204593430073
2989,The Collection,9929706,6842058,3087648,2012,0.6890494038796314,0.3109505961203685
2990,Portrait of a Lady on Fire,9921185,3759854,6161331,2019,0.37897226994557603,0.6210277300544239
2991,Never Let Me Go,9904795,2434652,7470143,2010,0.24580539021756634,0.7541946097824337
2992,Whatever It Takes,9902115,8745680,1156435,2000,0.8832133337170898,0.11678666628291026
2993,The Princess and the Matchmaker,9899017,78900,9820117,2018,0.007970488382836398,0.9920295116171636
2994,Arctic Dogs,9891463,5801249,4090214,2019,0.5864904918514077,0.4135095081485924
2995,The Dark Knight 2018 Re-release,9891372,375589,9515783,2018,0.03797137545731775,0.9620286245426822
2996,Tsotsi,9891303,2912606,6978697,2005,0.29446130605846366,0.7055386939415363
2997,Mostly Martha,9852022,4160475,5691547,2002,0.4222965600361022,0.5777034399638977
2998,Simmba,9846453,5102129,4744324,2018,0.5181692331238468,0.4818307668761533
2999,Mondays in the Sun,9832663,153256,9679407,2002,0.015586418450423857,0.9844135815495761
3000,3 Strikes,9832166,9832166,0,2000,1.0,0.0
3001,Ghost in the Shell 2: Innocence,9789651,1043896,8745755,2004,0.10663260620833163,0.8933673937916684
3002,Young & Beautiful,9757417,61067,9696350,2013,0.0062585210819625725,0.9937414789180374
3003,Tamjung Hong Gil-dong: Sarajin Ma-eul,9754195,67054,9687141,2016,0.006874375589169583,0.9931256244108304
3004,Maudie,9733932,6170998,3562934,2017,0.6339676504828675,0.3660323495171324
3005,My Life Without Me,9726954,400948,9326006,2003,0.041220303910144945,0.958779696089855
3006,Bread and Tulips,9719848,5318679,4401169,2000,0.547197754532787,0.4528022454672131
3007,Popstar: Never Stop Never Stopping,9680029,9639125,40904,2016,0.9957743928246496,0.0042256071753504045
3008,Tod@s Caen,9667157,2670925,6996232,2019,0.2762885717072765,0.7237114282927235
3009,In Darkness,9661759,1041455,8620304,2012,0.10779144874137307,0.892208551258627
3010,Overdrive,9650552,7793,9642759,2017,0.0008075185751032687,0.9991924814248967
3011,The Young Black Stallion,9638389,6751389,2887000,2003,0.7004686156576582,0.29953138434234183
3012,On the Road,9617377,744296,8873081,2012,0.07739074801788472,0.9226092519821153
3013,Private,9595697,15811,9579886,2005,0.0016477177218080145,0.998352282278192
3014,Paterson,9588282,2152738,7435544,2016,0.22451759345417668,0.7754824065458233
3015,Hysteria,9584256,1804139,7780117,2011,0.1882398592024253,0.8117601407975746
3016,The Man Without a Past,9564237,921847,8642390,2002,0.0963847926394965,0.9036152073605035
3017,God of War,9559524,53000,9506524,2017,0.005544209104972172,0.9944557908950278
3018,Traffik,9515914,9186156,329758,2018,0.9653466813592473,0.034653318640752745
3019,The Young and Prodigious T.S. Spivet,9494789,173564,9321225,2013,0.01827992175497528,0.9817200782450247
3020,The Square,9493791,1502347,7991444,2017,0.15824521521487042,0.8417547847851296
3021,Point Blank,9487445,708215,8779230,2010,0.07464760006513872,0.9253523999348613
3022,Our Time Will Come,9484714,114560,9370154,2017,0.012078382120957996,0.987921617879042
3023,The Mayor 2017 Re-release,9476194,96777,9379417,2017,0.010212644443539252,0.9897873555564608
3024,Official Secrets,9473603,1988546,7485057,2019,0.20990387712045777,0.7900961228795422
3025,Promare,9465371,2313596,7151775,2019,0.24442739751035644,0.7555726024896435
3026,Peepli [Live],9460931,757951,8702980,2010,0.08011378584200646,0.9198862141579935
3027,Superbabies: Baby Geniuses 2,9448644,9219388,229256,2004,0.9757366242182476,0.024263375781752385
3028,Veronica Guerin,9439660,1571504,7868156,2003,0.1664788774171951,0.8335211225828049
3029,The Big Bad Fox and Other Tales 2017 Re-release,9422127,35787,9386340,2017,0.0037981869698848255,0.9962018130301151
3030,Ghost Dog: The Way of the Samurai,9380473,3308029,6072444,2000,0.3526505539752633,0.6473494460247367
3031,Bel Ami,9374932,120462,9254470,2012,0.01284937320078695,0.9871506267992131
3032,You Were Never Really Here,9360514,2528078,6832436,2017,0.2700789721590075,0.7299210278409924
3033,Saving Private Perez,9330465,1400726,7929739,2011,0.15012392201246133,0.8498760779875387
3034,Replicas,9330075,4046429,5283646,2018,0.4336973711358162,0.5663026288641838
3035,The Story of the Weeping Camel,9328652,1763052,7565600,2004,0.18899322217186362,0.8110067778281363
3036,MacGruber,9322895,8525600,797295,2010,0.9144798906348296,0.08552010936517036
3037,Peeples,9307166,9177065,130101,2013,0.9860214161861945,0.013978583813805406
3038,Mad Love,9306362,280046,9026316,2001,0.030091887678557958,0.969908112321442
3039,Secretary,9304609,4059680,5244929,2002,0.4363085004431675,0.5636914995568325
3040,Mid90s,9303022,7362439,1940583,2018,0.7914029441185886,0.20859705588141145
3041,Hello Greetings,9289939,1413283,7876656,2005,0.15213049299893142,0.8478695070010686
3042,Jerusalem,9279456,8020721,1258735,2013,0.8643525008362559,0.13564749916374408
3043,Le Chef,9245235,342667,8902568,2012,0.03706417413943507,0.9629358258605649
3044,We Need to Talk About Kevin,9232318,1738692,7493626,2011,0.1883267019181965,0.8116732980818036
3045,The Aftermath,9215591,1618497,7597094,2019,0.17562595822666174,0.8243740417733383
3046,State and Main,9206279,6944471,2261808,2000,0.7543189816428548,0.24568101835714515
3047,Tulip Fever,9204549,2455635,6748914,2017,0.2667849342754327,0.7332150657245673
3048,My Cousin Rachel,9200168,2716368,6483800,2017,0.2952519997460916,0.7047480002539084
3049,A Hologram for the King,9169507,4212494,4957013,2016,0.4594024520620356,0.5405975479379644
3050,Unfinished Song,9166865,1702668,7464197,2013,0.18574158122760617,0.8142584187723938
3051,The Raid: Redemption,9148519,4105187,5043332,2012,0.4487269469517416,0.5512730530482585
3052,Ruby Sparks,9128263,2540106,6588157,2012,0.2782682751362444,0.7217317248637556
3053,My Piece of the Pie,9123187,6850,9116337,2011,0.0007508341109307526,0.9992491658890692
3054,Searching for Sugar Man,9122406,3696196,5426210,2012,0.40517775683301094,0.5948222431669891
3055,City Of Rock,9118873,312537,8806336,2017,0.034273643245168565,0.9657263567548314
3056,Human Capital,9113941,158549,8955392,2014,0.017396316258795178,0.9826036837412048
3057,Miss Sloane,9101546,3500605,5600941,2016,0.3846165255880704,0.6153834744119295
3058,Meet the Blacks,9097072,9097072,0,2016,1.0,0.0
3059,Tolkien,9090040,4535154,4554886,2019,0.4989146362392245,0.5010853637607755
3060,Mad Hot Ballroom,9079042,8117961,961081,2005,0.8941429062669828,0.1058570937330172
3061,Twice Born,9075131,18295,9056836,2012,0.002015948860683113,0.9979840511393169
3062,Me and Earl and the Dying Girl,9074749,6758416,2316333,2015,0.7447496343976016,0.2552503656023985
3063,Monsieur Lazhar,9074711,2009517,7065194,2012,0.22144143212935377,0.7785585678706463
3064,The Fifth Estate,9058564,3255008,5803556,2013,0.3593293594878835,0.6406706405121165
3065,El Crimen Perfecto (The Perfect Crime),9040997,418843,8622154,2004,0.04632708096242041,0.9536729190375796
3066,Incarnate,9037058,4799774,4237284,2016,0.5311213007596056,0.4688786992403944
3067,Like Crazy,9029150,107362,8921788,2016,0.011890598782831163,0.9881094012171688
3068,Truman,9027600,210840,8816760,2015,0.02335504453010767,0.9766449554698924
3069,"Two Days, One Night",9016922,1436243,7580679,2014,0.15928306799149422,0.8407169320085058
3070,Frances Ha,9013161,4069826,4943335,2013,0.45154258311817574,0.5484574168818243
3071,Champion,8974547,97472,8877075,2018,0.010860938162115592,0.9891390618378844
3072,Jexi,8952550,6546159,2406391,2019,0.7312060809490034,0.26879391905099664
3073,The Lobster 2016 Re-release,8952351,8700374,251977,2016,0.9718535388078506,0.028146461192149416
3074,Kandahar,8914751,1418314,7496437,2001,0.15909743300738294,0.8409025669926171
3075,Hannah Arendt,8880936,717205,8163731,2013,0.08075781651843905,0.919242183481561
3076,Bluebeard,8855737,43144,8812593,2017,0.0048718700656986535,0.9951281299343013
3077,Après Vous,8852763,830292,8022471,2003,0.09378902383357603,0.906210976166424
3078,All Together,8835903,43180,8792723,2012,0.004886880265661585,0.9951131197343385
3079,Morgan,8809407,3915251,4894156,2016,0.4444397903286793,0.5555602096713207
3080,Captive State,8808611,5958315,2850296,2019,0.6764193582847511,0.32358064171524886
3081,18 ans après,8785730,25611,8760119,2003,0.0029150679567890203,0.997084932043211
3082,Son of the Bride,8772695,624757,8147938,2001,0.07121608582083384,0.9287839141791662
3083,7 Days in Entebbe,8771432,3326885,5444547,2018,0.379286415262639,0.620713584737361
3084,Ghost World,8764007,6217849,2546158,2001,0.7094755857680168,0.29052441423198316
3085,The Traitor,8756847,296027,8460820,2019,0.03380520408772701,0.966194795912273
3086,Marguerite,8754356,506677,8247679,2015,0.0578771299682124,0.9421228700317876
3087,La folle histoire de Max et Léon,8750678,543,8750135,2016,6.205233468766649e-05,0.9999379476653123
3088,Sorry We Missed You,8746534,28273,8718261,2019,0.0032324804316772792,0.9967675195683228
3089,The Villainess,8737458,27741,8709717,2017,0.003174950883884077,0.9968250491161159
3090,Code Geass: Lelouch of the Re;Surrection 2019 Re-release,8715612,522805,8192807,2019,0.05998488689032967,0.9400151131096703
3091,Infernal Affairs,8708932,169659,8539273,2002,0.019481033954565265,0.9805189660454348
3092,The Forsaken,8704851,7288451,1416400,2001,0.8372861293088187,0.16271387069118126
3093,The Station Agent,8679814,5739376,2940438,2003,0.661232602449776,0.338767397550224
3094,Le Week-end,8652213,2225098,6427115,2013,0.257170968860799,0.7428290311392011
3095,Pope Francis: A Man of His Word,8608385,2008385,6600000,2018,0.23330566651003642,0.7666943334899635
3096,Love Me If You Dare,8561371,553504,8007867,2003,0.06465132745678233,0.9353486725432176
3097,Willard,8546666,6886089,1660577,2003,0.8057047040331282,0.19429529596687176
3098,Space Dogs,8530226,14408,8515818,2010,0.0016890525526521807,0.9983109474473478
3099,Our Brand Is Crisis,8527658,7002261,1525397,2015,0.8211235722633342,0.1788764277366658
3100,Before Night Falls,8527517,4242892,4284625,2000,0.49755303917893096,0.502446960821069
3101,What If,8526288,3493000,5033288,2014,0.40967417474052015,0.5903258252594799
3102,Stronger,8503658,4211129,4292529,2017,0.495213824450607,0.504786175549393
3103,Big Trouble,8493890,7267307,1226583,2002,0.8555923140045374,0.1444076859954626
3104,Piranha 3DD,8493728,376512,8117216,2012,0.044328238436644074,0.9556717615633559
3105,La mujer de mi hermano,8492178,2808241,5683937,2005,0.3306856026804902,0.6693143973195098
3106,Star Wars: Episode II - Attack of the Clones 2002 IMAX Release,8485488,8485488,0,2002,1.0,0.0
3107,Stay,8483797,3626883,4856914,2005,0.4275070466679012,0.5724929533320988
3108,Amityville: The Awakening,8481997,742,8481255,2017,8.747939901417083e-05,0.9999125206009858
3109,A-X-L,8467697,6501381,1966316,2018,0.767786211528353,0.232213788471647
3110,The Outrage,8457741,44745,8412996,2010,0.005290419746833109,0.9947095802531669
3111,Beyond the Sea,8447615,6318709,2128906,2004,0.7479873313355307,0.2520126686644692
3112,Casa de mi Padre,8446952,5909483,2537469,2012,0.6995994531518588,0.3004005468481412
3113,A Street Cat Named Bob,8446262,82703,8363559,2016,0.009791668787920621,0.9902083312120794
3114,Princesas,8446185,29472,8416713,2005,0.003489386036417625,0.9965106139635824
3115,The Way 2010 Re-release,8437872,4430765,4007107,2010,0.5251045524274367,0.4748954475725633
3116,Condorito: The Movie,8431194,447719,7983475,2017,0.053102680355830975,0.946897319644169
3117,Raees,8428190,3262954,5165236,2017,0.38714765566509535,0.6128523443349047
3118,Amen.,8419052,274299,8144753,2002,0.032580746620878454,0.9674192533791215
3119,Go for Zucker,8394115,87490,8306625,2005,0.01042277833934846,0.9895772216606515
3120,Death to Smoochy,8382938,8364691,18247,2002,0.997823316837128,0.0021766831628720145
3121,Bones,8378853,7316658,1062195,2001,0.8732290684655764,0.12677093153442362
3122,Filth,8377987,34411,8343576,2013,0.004107311219270214,0.9958926887807298
3123,Easy Money,8369756,205741,8164015,2010,0.024581481228365558,0.9754185187716344
3124,The Love Punch,8366493,266588,8099905,2014,0.031863768965084895,0.9681362310349151
3125,Venus in Fur,8350026,373605,7976421,2013,0.04474297445301368,0.9552570255469863
3126,I Am Not Your Negro,8345298,7123919,1221379,2017,0.8536446511556568,0.14635534884434326
3127,Time Renegades,8312361,59425,8252936,2016,0.007148991724493198,0.9928510082755068
3128,London Boulevard,8307227,16075,8291152,2010,0.0019350620850977108,0.9980649379149023
3129,The Office,8290521,63675,8226846,2015,0.007680458200395367,0.9923195417996047
3130,My Worst Nightmare,8226544,21952,8204592,2011,0.0026684352505742387,0.9973315647494257
3131,It Runs in the Family,8211508,7491839,719669,2003,0.912358485189322,0.08764151481067789
3132,The Machinist,8203235,1082715,7120520,2004,0.13198634441168636,0.8680136555883137
3133,Santa vs. the Snowman 3D,8198286,1934053,6264233,2002,0.23590943277655843,0.7640905672234416
3134,Cave of Forgotten Dreams,8183347,5304920,2878427,2011,0.6482579805060203,0.35174201949397965
3135,The Big Year,8179416,7204138,975278,2011,0.880764347968119,0.11923565203188101
3136,The Edukators,8152859,175493,7977366,2004,0.02152533240179917,0.9784746675982008
3137,Impostor,8145549,6285176,1860373,2002,0.7716086417256836,0.22839135827431645
3138,Mangal Pandey: The Rising,8142076,954108,7187968,2005,0.11718239918173202,0.882817600818268
3139,Walk of Shame,8122990,59209,8063781,2014,0.0072890647409389895,0.992710935259061
3140,Spartan,8112712,4434432,3678280,2004,0.5466029115787667,0.4533970884212332
3141,Ernest & Celestine,8111137,262075,7849062,2012,0.03231051331027943,0.9676894866897205
3142,The New Year's Eve of Old Lee,8099301,25358,8073943,2016,0.0031308874679432212,0.9968691125320568
3143,The Man Who Invented Christmas,8096007,5676486,2419521,2017,0.7011463799376656,0.29885362006233446
3144,The Company Men,8087000,4441272,3645728,2011,0.5491865957709905,0.4508134042290095
3145,The Hidden Blade,8043781,38147,8005634,2004,0.004742421505508417,0.9952575784944916
3146,Heroine,8036853,598668,7438185,2012,0.07449035088734358,0.9255096491126564
3147,Me and You and Everyone We Know,8012838,3885134,4127704,2005,0.48486366503353745,0.5151363349664626
3148,My King,8003331,54114,7949217,2015,0.0067614347076236135,0.9932385652923764
3149,Disobedience,8003180,3498782,4504398,2018,0.4371739733455951,0.5628260266544048
3150,Life Itself,7997774,4102648,3895126,2018,0.5129737349417476,0.48702626505825247
3151,Denial,7994527,4073489,3921038,2016,0.5095347104337755,0.4904652895662245
3152,American Splendor,7986084,6010990,1975094,2003,0.7526830421518231,0.2473169578481769
3153,Metallica Through the Never,7975812,3419967,4555845,2013,0.42879232860553884,0.5712076713944612
3154,Merci pour le Chocolat,7972251,443238,7529013,2002,0.05559759721564211,0.9444024027843579
3155,Fanfan,7949963,32686,7917277,2003,0.0041114656760037754,0.9958885343239963
3156,Chasing Mavericks,7942116,6002756,1939360,2012,0.7558131863095428,0.2441868136904573
3157,Suspiria,7942093,2483472,5458621,2018,0.3126974211961507,0.6873025788038493
3158,Coffee and Cigarettes,7929307,2198924,5730383,2004,0.2773160378328144,0.7226839621671856
3159,The Ark of Mr Chow,7894075,54075,7840000,2015,0.006850074264559179,0.9931499257354408
3160,Gardener,7885479,1058803,6826676,2003,0.13427250265963553,0.8657274973403645
3161,Pavarotti,7885016,4600249,3284767,2019,0.5834165713804512,0.4165834286195488
3162,The Battle of Jangsari,7883200,70853,7812347,2019,0.008987847574589,0.991012152425411
3163,Inside Job,7871522,4312735,3558787,2010,0.5478908653243935,0.4521091346756066
3164,For a Few Bullets,7860447,30142,7830305,2016,0.0038346419739233657,0.9961653580260766
3165,Salut d'Amour,7858183,22480,7835703,2015,0.0028607122028082065,0.9971392877971917
3166,Pele: Birth of a Legend,7846608,57046,7789562,2016,0.007270147814189265,0.9927298521858108
3167,The Lady,7832142,355391,7476751,2011,0.04537596483822689,0.9546240351617731
3168,Batman Begins 2012 Re-release,7826402,1508658,6317744,2012,0.19276520679617531,0.8072347932038247
3169,Renoir,7816573,2293798,5522775,2013,0.2934531539589024,0.7065468460410975
3170,Dongju: The Portrait of a Poet,7809531,56550,7752981,2016,0.007241151869427242,0.9927588481305728
3171,Tupac: Resurrection,7808524,7718961,89563,2003,0.9885300986460437,0.011469901353956266
3172,Qué León,7807916,2607916,5200000,2018,0.33400922858288945,0.6659907714171105
3173,Bad Words,7804337,7779614,24723,2014,0.9968321460234226,0.0031678539765773828
3174,Amazing Grace,7796112,4450456,3345656,2018,0.5708558317274046,0.4291441682725954
3175,Real Women Have Curves,7777790,5853194,1924596,2002,0.7525523317034788,0.24744766829652126
3176,By the Grace of God,7755652,67059,7688593,2019,0.00864646840781407,0.991353531592186
3177,3 idiotas,7738470,1249233,6489237,2017,0.16143152328561072,0.8385684767143893
3178,Certified Copy,7736632,1373975,6362657,2010,0.17759342825146654,0.8224065717485335
3179,Butterfly,7733894,2092682,5641212,2000,0.27058581356299943,0.7294141864370005
3180,Love Live! Sunshine!! The School Idol Movie: Over The Rainbow,7733048,34135,7698913,2019,0.004414171488396296,0.9955858285116037
3181,Explosion,7731410,122700,7608710,2017,0.015870326369963564,0.9841296736300365
3182,Cedar Rapids,7728936,6861102,867834,2011,0.8877162393374716,0.11228376066252845
3183,Mia madre,7723656,303002,7420654,2015,0.03923038519581918,0.9607696148041808
3184,The Sweeney,7708312,26650,7681662,2012,0.0034573068656276497,0.9965426931343724
3185,Kevin Hart: Laugh at My Pain,7706436,7706436,0,2011,1.0,0.0
3186,BPM (Beats Per Minute),7704369,125189,7579180,2017,0.01624909191135575,0.9837509080886443
3187,Penguins,7699452,7699452,0,2019,1.0,0.0
3188,No,7699095,2343664,5355431,2012,0.30440772584310233,0.6955922741568976
3189,Declaration of War,7691610,59100,7632510,2011,0.007683696911309856,0.9923163030886901
3190,Finding Fanny,7685784,615691,7070093,2014,0.08010776779571219,0.9198922322042878
3191,Leave No Trace,7682928,6046104,1636824,2018,0.7869530991309563,0.21304690086904368
3192,Lolo,7663798,24134,7639664,2015,0.0031490913513117125,0.9968509086486883
3193,Steal,7662206,220944,7441262,2002,0.02883555988967146,0.9711644401103285
3194,Sex and Lucía,7640680,1594779,6045901,2001,0.2087221294439762,0.7912778705560238
3195,Pandas,7635778,7574012,61766,2018,0.9919109748869074,0.008089025113092601
3196,Just Getting Started,7634022,6069605,1564417,2017,0.7950730296559271,0.2049269703440729
3197,The White Crow,7622595,1828784,5793811,2019,0.23991619651837728,0.7600838034816227
3198,Monkeybone,7622365,5411999,2210366,2001,0.7100157234664044,0.28998427653359554
3199,Fullmetal Alchemist: The Sacred Star of Milos,7621364,177802,7443562,2011,0.023329419773153465,0.9766705802268465
3200,Only Lovers Left Alive,7609187,1879534,5729653,2013,0.24700851746710917,0.7529914825328908
3201,The Flower of Evil,7587959,182163,7405796,2003,0.024006850854096602,0.9759931491459034
3202,Man on the Train,7585989,2542020,5043969,2002,0.33509407936130675,0.6649059206386932
3203,Klovn Forever,7585569,5700,7579869,2015,0.0007514268211125625,0.9992485731788875
3204,Burning,7576345,718991,6857354,2018,0.0948994534963759,0.9051005465036241
3205,Miss You Already,7573997,1162653,6411344,2015,0.15350587015019942,0.8464941298498005
3206,Club Dread,7565807,5001708,2564099,2004,0.6610937868227408,0.3389062131772592
3207,Hippocrates: Diary of a French Doctor,7555591,23050,7532541,2014,0.003050720982647155,0.9969492790173529
3208,"Kiki, Love to Love",7551282,12450,7538832,2016,0.001648726666544833,0.9983512733334552
3209,The Advocate: A Missing Body,7550177,50162,7500015,2015,0.006643817754206292,0.9933561822457937
3210,Take Me Home Tonight,7550073,6928068,622005,2011,0.9176160283483352,0.08238397165166482
3211,A Bigger Splash,7545758,2024099,5521659,2015,0.2682432964322471,0.7317567035677529
3212,Albert Nobbs,7532259,3014696,4517563,2011,0.4002379631396106,0.5997620368603894
3213,Beirut,7509436,5019226,2490210,2018,0.6683892105878524,0.3316107894121476
3214,Where Do We Go Now?,7507008,531997,6975011,2011,0.07086671547439406,0.929133284525606
3215,Open Season 3,7487555,0,7487555,2010,0.0,1.0
3216,Frantz,7478354,880883,6597471,2016,0.11779102727685799,0.882208972723142
3217,The Tall Man,7462847,0,7462847,2012,0.0,1.0
3218,Spellbound,7457710,5728581,1729129,2003,0.7681420972389648,0.2318579027610352
3219,Big Game,7455398,24752,7430646,2015,0.0033200105480619547,0.996679989451938
3220,Black Nativity,7454185,7018189,435996,2013,0.941509903497163,0.058490096502837
3221,I'll See You in My Dreams,7452512,7449681,2831,2015,0.999620128085671,0.00037987191432902086
3222,Yu-Gi-Oh!: The Dark Side of Dimensions,7445186,1015339,6429847,2016,0.13637523629362652,0.8636247637063735
3223,Five Times Two,7444906,128752,7316154,2004,0.017293972549821315,0.9827060274501787
3224,Brittany Runs a Marathon,7442106,7189808,252298,2019,0.9660985747851482,0.033901425214851816
3225,Mayday Life,7435496,85912,7349584,2019,0.011554306531803662,0.9884456934681963
3226,Genius,7435006,1361045,6073961,2016,0.1830590318286226,0.8169409681713774
3227,Beatriz at Dinner,7425391,7115854,309537,2017,0.958313710348721,0.04168628965127897
3228,God's Not Dead: A Light in Darkness,7414178,5728940,1685238,2018,0.7727006284445828,0.2272993715554172
3229,Goodbye Christopher Robin,7401949,1735251,5666698,2017,0.23443163415473411,0.7655683658452659
3230,The Innocents,7400324,1065665,6334659,2016,0.14400247881038722,0.8559975211896128
3231,Requiem for a Dream,7390108,3635482,3754626,2000,0.49193895407211913,0.5080610459278809
3232,Return of the Hero,7362730,37108,7325622,2018,0.005039978377585488,0.9949600216224145
3233,I'm Not Scared,7354418,1615328,5739090,2003,0.21964049364613217,0.7803595063538679
3234,Compadres,7353544,3127773,4225771,2016,0.4253422567404234,0.5746577432595766
3235,The Young Messiah,7330338,6490401,839937,2016,0.8854163341444828,0.11458366585551717
3236,Even the Rain,7313485,518017,6795468,2011,0.07083039070976423,0.9291696092902357
3237,Dhoom,7312209,245756,7066453,2004,0.033608995585328594,0.9663910044146714
3238,Mean Machine,7310206,92770,7217436,2001,0.012690476848395244,0.9873095231516048
3239,Respiro,7309845,1072834,6237011,2002,0.14676562909336655,0.8532343709066335
3240,The Beaver,7294800,970816,6323984,2011,0.13308329220814827,0.8669167077918517
3241,The Midwife,7286136,603582,6682554,2017,0.08283979327314231,0.9171602067268577
3242,Gigli,7266209,6087542,1178667,2003,0.8377879028803052,0.16221209711969475
3243,A Long Way Down,7257942,13347,7244595,2014,0.0018389510414935804,0.9981610489585064
3244,Where the Money Is,7243669,5661798,1581871,2000,0.7816201982724501,0.21837980172754995
3245,Let There Be Light,7233471,7233471,0,2017,1.0,0.0
3246,Birth of the Dragon,7215027,6901965,313062,2017,0.95660972578481,0.043390274215190046
3247,20th Century Women,7214806,5664764,1550042,2016,0.785158187205588,0.21484181279441195
3248,Animal Kingdom,7208231,1044039,6164192,2010,0.14483983657016541,0.8551601634298346
3249,Grandma,7205073,6980524,224549,2015,0.9688345975120585,0.03116540248794148
3250,Screwed,7201701,7027345,174356,2000,0.9757896085938585,0.02421039140614141
3251,The Hunt,7195581,5812500,1383081,2020,0.8077874462117791,0.19221255378822086
3252,The Widow of Saint-Pierre,7193889,3193889,4000000,2000,0.44397251611749916,0.5560274838825008
3253,Timbuktu,7179391,1076075,6103316,2014,0.1498838829087314,0.8501161170912686
3254,Blade of the Immortal,7162617,150532,7012085,2017,0.021016340815095937,0.978983659184904
3255,Wild Rose,7123449,1635117,5488332,2019,0.22954007251262695,0.770459927487373
3256,Jet Lag,7121171,250000,6871171,2002,0.03510658570058211,0.9648934142994179
3257,The Adventures of Pluto Nash,7103973,4420080,2683893,2002,0.6221983107199309,0.3778016892800691
3258,Postman Pat: The Movie,7102455,1519,7100936,2014,0.00021386971124773055,0.9997861302887523
3259,Incendies,7099598,2071334,5028264,2011,0.2917537021110209,0.7082462978889791
3260,The Truth About Charlie,7093284,5350371,1742913,2002,0.7542868719199739,0.24571312808002613
3261,In Safe Hands,7086596,1737,7084859,2018,0.0002451106285725897,0.9997548893714274
3262,Croupier,7075068,6201143,873925,2000,0.8764782190079304,0.12352178099206962
3263,Gosanja: Dae-dong-yeo Ji-do,7035812,34034,7001778,2016,0.004837252615618496,0.9951627473843815
3264,The Joneses,7031729,1475746,5555983,2010,0.2098695783071276,0.7901304216928724
3265,Cosmopolis,7029095,763556,6265539,2012,0.10862792436295142,0.8913720756370486
3266,The Killing of a Sacred Deer,7027336,2291901,4735435,2017,0.3261408021474994,0.6738591978525006
3267,Innocent Voices,7015131,837878,6177253,2005,0.11943868190059459,0.8805613180994054
3268,The Kid with a Bike,7011798,1470000,5541798,2011,0.20964665553685374,0.7903533444631463
3269,Jessabelle,6998359,0,6998359,2014,0.0,1.0
3270,Goon,6985158,4168528,2816630,2012,0.5967693214670305,0.40323067853296946
3271,The Princess of Montpensier,6965201,352428,6612773,2010,0.05059839622718713,0.9494016037728129
3272,11-11-11,6963872,32771,6931101,2011,0.004705859039339034,0.9952941409606609
3273,"Spring, Summer, Fall, Winter... and Spring",6959791,2380788,4579003,2003,0.34207751353453,0.65792248646547
3274,The Salesman,6953604,2402067,4551537,2016,0.3454420182685123,0.6545579817314877
3275,Santa vs. the Snowman 3D 2003 Re-release,6952764,3045032,3907732,2003,0.4379599250024882,0.5620400749975117
3276,What We Do in the Shadows,6946808,3469224,3477584,2014,0.49939828479497345,0.5006017152050265
3277,Father and Sons,6935839,634968,6300871,2003,0.09154883785508862,0.9084511621449114
3278,Igby Goes Down,6919198,4777465,2141733,2002,0.6904651377226089,0.30953486227739113
3279,The Spectacular Now,6918591,6854611,63980,2013,0.9907524523418135,0.009247547658186472
3280,Don 2,6913518,3680306,3233212,2011,0.5323347679141068,0.46766523208589317
3281,Painted Fire,6906235,64029,6842206,2002,0.00927118755733044,0.9907288124426695
3282,Centurion,6890432,123570,6766862,2010,0.01793356352693126,0.9820664364730688
3283,Barbara,6889185,1013902,5875283,2012,0.147172996515553,0.852827003484447
3284,Veer-Zaara,6887221,2938532,3948689,2004,0.4266643977302311,0.5733356022697689
3285,Woman Thou Art Loosed,6879730,6879730,0,2004,1.0,0.0
3286,The Awakening,6879667,209696,6669971,2011,0.03048054506126532,0.9695194549387347
3287,Talvar,6879098,342370,6536728,2015,0.049769606422237336,0.9502303935777626
3288,A Good Woman,6878433,238609,6639824,2005,0.034689441621369284,0.9653105583786307
3289,Last Orders,6873892,2329631,4544261,2002,0.33891003815596754,0.6610899618440325
3290,Bee Season,6856989,1180560,5676429,2005,0.17216886303886444,0.8278311369611355
3291,Dog Days,6842356,6809080,33276,2018,0.995136762834322,0.004863237165678021
3292,Commitment,6834802,76543,6758259,2013,0.011199007666937535,0.9888009923330625
3293,Collide,6817535,2280004,4537531,2016,0.3344323131454404,0.6655676868545596
3294,Race 3,6817391,1690861,5126530,2018,0.2480217138785204,0.7519782861214797
3295,Bran Nue Dae,6812530,113568,6698962,2010,0.016670458698897474,0.9833295413011025
3296,The Aristocrats,6809089,6377461,431628,2005,0.9366100222805136,0.06338997771948642
3297,The Big Bounce,6808550,6489476,319074,2004,0.9531362771808976,0.04686372281910245
3298,The Names of Love,6803887,514237,6289650,2010,0.07557988543901449,0.9244201145609855
3299,Baahubali: The Beginning,6787855,6738000,49855,2015,0.9926552644392079,0.007344735560792032
3300,China: The Panda Adventure,6784985,3921642,2863343,2001,0.5779883080065763,0.4220116919934237
3301,The Road Home,6780490,1280490,5500000,2001,0.1888491834660917,0.8111508165339083
3302,A Little Bit of Heaven,6778388,15375,6763013,2011,0.002268238407125706,0.9977317615928742
3303,The Sun Is Also a Star,6750029,4950029,1800000,2019,0.7333344790074235,0.26666552099257645
3304,The Piano Teacher,6749315,1012069,5737246,2001,0.14995136543486265,0.8500486345651374
3305,Séraphin: un homme et son péché,6749187,6749187,0,2002,1.0,0.0
3306,A Letter to Momo,6748888,71712,6677176,2012,0.010625750494007309,0.9893742495059927
3307,R-Point,6744984,0,6744984,2004,0.0,1.0
3308,Midnight Special,6740647,3712282,3028365,2016,0.5507308126356416,0.44926918736435834
3309,Wild Card,6738764,0,6738764,2015,0.0,1.0
3310,Churchill,6724365,1281258,5443107,2017,0.19053962716182124,0.8094603728381787
3311,Cesar Chavez 2014 Re-release,6719925,5571497,1148428,2014,0.8291010688363337,0.17089893116366625
3312,The Door in the Floor,6715067,3854624,2860443,2004,0.5740261415113207,0.42597385848867925
3313,Jab Tak Hai Jaan,6703114,3047539,3655575,2012,0.45464525890504026,0.5453547410949597
3314,Bleed for This,6698679,5083906,1614773,2016,0.7589415763914049,0.24105842360859506
3315,Fragile,6680926,0,6680926,2005,0.0,1.0
3316,Fahrenheit 11/9,6674168,6352306,321862,2018,0.9517749628118441,0.048225037188155885
3317,Son of Saul,6659121,1777043,4882078,2015,0.2668584937861919,0.7331415062138081
3318,The Conquest,6637166,74474,6562692,2011,0.011220752953896287,0.9887792470461038
3319,Spider-Man/Men in Black II,6632970,6632970,0,2002,1.0,0.0
3320,Southside with You,6628603,6304223,324380,2016,0.9510635951496869,0.04893640485031311
3321,Duets,6620242,4739023,1881219,2000,0.7158383334023137,0.2841616665976863
3322,Pieta,6616296,22080,6594216,2012,0.003337214659078131,0.9966627853409219
3323,Against the Ropes,6596511,5884190,712321,2004,0.892015491219525,0.10798450878047501
3324,The Red Turtle,6591789,921974,5669815,2016,0.13986703761300612,0.8601329623869939
3325,Mambo Italiano 2003 Re-release,6590962,3205730,3385232,2003,0.48638271621047124,0.5136172837895288
3326,I Capture the Castle,6586341,1179035,5407306,2003,0.1790121404281983,0.8209878595718016
3327,Ned Kelly,6585516,86959,6498557,2003,0.013204584120667233,0.9867954158793327
3328,Soorma,6579645,390077,6189568,2018,0.05928541737434163,0.9407145826256583
3329,Fleabag,6572099,326283,6245816,2019,0.04964669582731483,0.9503533041726852
3330,The Raid 2,6566916,2627209,3939707,2014,0.4000673984561398,0.5999326015438602
3331,A Melody to Remember,6559996,44263,6515733,2016,0.006747412650861372,0.9932525873491387
3332,Ae Fond Kiss,6547641,30148,6517493,2004,0.004604406380862971,0.995395593619137
3333,Bon voyage,6536601,148727,6387874,2003,0.022752956773711596,0.9772470432262884
3334,Under the Sand,6531687,1452698,5078989,2001,0.22240777918476498,0.777592220815235
3335,From the Land of the Moon 2016 Re-release,6524799,47748,6477051,2016,0.007317926575209443,0.9926820734247905
3336,The Measure of a Man,6518931,112391,6406540,2015,0.017240710171652376,0.9827592898283476
3337,The Lobster,6504366,376871,6127495,2015,0.057941235164195866,0.9420587648358041
3338,Wadjda,6499169,1347747,5151422,2012,0.20737220404639423,0.7926277959536058
3339,Teacher's Pet,6491969,6491969,0,2004,1.0,0.0
3340,It's Kind of a Funny Story,6491240,6363628,127612,2010,0.9803408901843099,0.01965910981569007
3341,Everybody Loves Somebody,6481798,1915789,4566009,2017,0.2955644406073747,0.7044355593926254
3342,Irreversible,6479328,792200,5687128,2002,0.12226576583250609,0.877734234167494
3343,Gloria,6461559,2107925,4353634,2013,0.32622545116433976,0.6737745488356602
3344,The Devil's Backbone,6459020,755249,5703771,2001,0.11692934841508464,0.8830706515849154
3345,Lassie,6442854,652163,5790691,2005,0.10122268795785222,0.8987773120421478
3346,Waiting for 'Superman',6433688,6417135,16553,2010,0.9974271366594091,0.002572863340590964
3347,Run the Race,6424420,6424420,0,2019,1.0,0.0
3348,Same Kind of Different as Me,6423605,6423605,0,2017,1.0,0.0
3349,Eye See You,6416302,79161,6337141,2002,0.01233748037420932,0.9876625196257907
3350,Slackers,6413915,5285941,1127974,2002,0.8241364283748693,0.17586357162513067
3351,Gotti,6412349,4343227,2069122,2018,0.6773223041977284,0.3226776958022715
3352,The Secret Life of Words,6410058,20678,6389380,2005,0.003225867847061602,0.9967741321529384
3353,The Mustang,6405816,5043620,1362196,2019,0.7873501205779249,0.2126498794220752
3354,The Company,6401690,2283914,4117776,2003,0.3567673536206845,0.6432326463793154
3355,A Journey Through Time with Antony,6389648,127381,6262267,2015,0.01993552696486567,0.9800644730351343
3356,"Farewell, My Queen",6366835,1597998,4768837,2012,0.25098781419653565,0.7490121858034644
3357,The Chorus 2005 Re-release,6353810,1548036,4805774,2005,0.2436390134423283,0.7563609865576717
3358,Greenberg,6344112,4234170,2109942,2010,0.6674172839319357,0.3325827160680644
3359,Hector and the Search for Happiness,6337728,1124445,5213283,2014,0.17742083598412553,0.8225791640158745
3360,Hampstead,6335171,144396,6190775,2017,0.02279275492326884,0.9772072450767312
3361,Closed Circuit,6331939,5750401,581538,2013,0.9081579907829181,0.09184200921708184
3362,Sheng zhe wei wang,6313827,163406,6150421,2015,0.02588065843425865,0.9741193415657413
3363,Lowriders,6312033,6303560,8473,2017,0.9986576432664405,0.0013423567335595363
3364,Absolutely Anything,6303792,20169,6283623,2015,0.003199502775472287,0.9968004972245277
3365,A Late Quartet,6303709,1562548,4741161,2012,0.24787755906879586,0.7521224409312042
3366,Las Pildoras De Mi Novio,6292780,2971116,3321664,2020,0.47214680951820975,0.5278531904817902
3367,High Tension,6291958,3681066,2610892,2003,0.5850430025120956,0.4149569974879044
3368,I Am Crazy About Love,6290342,1232228,5058114,2003,0.19589205165633283,0.8041079483436672
3369,Deuces Wild,6282446,6080065,202381,2002,0.9677862730535208,0.03221372694647913
3370,Max Steel,6272403,3818664,2453739,2016,0.6088039942586597,0.3911960057413403
3371,Innocence,6236288,294039,5942249,2014,0.04714968263171938,0.9528503173682806
3372,Norman,6217567,3814868,2402699,2017,0.6135628293189281,0.38643717068107186
3373,Unbroken: Path to Redemption,6216897,6216897,0,2018,1.0,0.0
3374,Attack the Block,6206022,1024175,5181847,2011,0.16502922484000218,0.8349707751599978
3375,Happily Ever After,6204504,252379,5952125,2005,0.04067674063873599,0.9593232593612641
3376,Great Expectations,6202879,258656,5944223,2012,0.041699346384154845,0.9583006536158452
3377,The Snitch Cartel,6197324,0,6197324,2012,0.0,1.0
3378,Yeh Jawaani Hai Deewani,6189998,3827466,2362532,2013,0.6183307329016907,0.38166926709830923
3379,Immortal Hero,6180032,43007,6137025,2019,0.006959025454884376,0.9930409745451156
3380,The Autopsy of Jane Doe,6170043,10474,6159569,2016,0.0016975570510610704,0.9983024429489389
3381,Tiger & Bunny: The Rising,6168617,34471,6134146,2014,0.005588124534235146,0.9944118754657648
3382,Darker Than Night,6160114,870063,5290051,2014,0.14124137962381866,0.8587586203761813
3383,The Patriarch,6156936,2156047,4000889,2016,0.3501818112125902,0.6498181887874098
3384,Four Lions,6148687,304616,5844071,2010,0.0495416338480069,0.9504583661519931
3385,Ploey,6146292,77815,6068477,2018,0.012660478870837898,0.9873395211291621
3386,Mobile Suit Gundam Narrative,6126259,259224,5867035,2018,0.04231358811307194,0.957686411886928
3387,Warriors of Heaven and Earth,6106178,82936,6023242,2003,0.013582309588747659,0.9864176904112524
3388,The Duelist,6101904,13450,6088454,2016,0.0022042300239400684,0.9977957699760599
3389,The Trip to Italy,6089109,2880537,3208572,2014,0.4730637930771152,0.5269362069228848
3390,Rosenstrasse,6075609,734519,5341090,2003,0.12089635787951462,0.8791036421204854
3391,Megiddo,6047691,6047691,0,2001,1.0,0.0
3392,Meet the Mormons,6047363,6047363,0,2014,1.0,0.0
3393,She's Funny That Way,6034851,111996,5922855,2015,0.01855820466818485,0.9814417953318152
3394,East/West,6031521,2321029,3710492,2000,0.384816533010496,0.615183466989504
3395,Matru's Bijlee's Mandola,6009116,0,6009116,2013,0.0,1.0
3396,The Illusionist,6007194,2231474,3775720,2010,0.3714669444669175,0.6285330555330825
3397,Russian Ark,6001714,2326979,3674735,2002,0.38771907491759855,0.6122809250824015
3398,Blue Exorcist: The Movie,5994921,21796,5973125,2012,0.0036357443242371335,0.9963642556757629
3399,The Broken Circle Breakdown,5990754,175058,5815696,2012,0.029221363454416588,0.9707786365455834
3400,The Rhythm Section,5989583,5437971,551612,2020,0.9079047740051353,0.09209522599486475
3401,"Cyrano, My Love",5985822,351019,5634803,2019,0.058641737091413675,0.9413582629085864
3402,The Butterfly,5983780,189144,5794636,2002,0.03160945088221826,0.9683905491177818
3403,Learning to Drive,5967516,3447633,2519883,2015,0.5777333483479559,0.4222666516520442
3404,The Immigrant,5952884,2025328,3927556,2013,0.340226350790642,0.659773649209358
3405,Chalte Chalte,5945422,836225,5109197,2003,0.14065023475204955,0.8593497652479505
3406,All Saints,5942565,5802208,140357,2017,0.9763810745023404,0.02361892549765968
3407,Don't Tell,5923415,29015,5894400,2005,0.004898356775610016,0.99510164322439
3408,Never Die Alone,5923000,5645298,277702,2004,0.9531146378524397,0.04688536214756036
3409,Callas Forever,5906353,446955,5459398,2002,0.07567360095138236,0.9243263990486177
3410,Death of a Nation,5885881,5885881,0,2018,1.0,0.0
3411,Maggie's Plan,5883891,3351735,2532156,2016,0.5696460046591618,0.43035399534083824
3412,Underclassman,5879555,5655459,224096,2005,0.9618855508622677,0.03811444913773236
3413,Testament of Youth,5874883,1822250,4052633,2015,0.31017638989576474,0.6898236101042353
3414,My Life as a Zucchini,5872598,309766,5562832,2016,0.05274769361022157,0.9472523063897784
3415,Aim,5859242,753600,5105642,2004,0.12861731944166158,0.8713826805583385
3416,Tracks,5853509,510007,5343502,2014,0.08712842160147016,0.9128715783985298
3417,20 Feet from Stardom,5839368,4946445,892923,2013,0.847085677765128,0.152914322234872
3418,The Hero: Love Story of a Spy,5835846,285394,5550452,2003,0.04890362082892523,0.9510963791710748
3419,Young Goethe in Love,5826565,162138,5664427,2010,0.027827373418128864,0.9721726265818711
3420,Puella Magi Madoka Magica the Movie Part 1: Beginnings,5816330,180440,5635890,2012,0.031022999038912855,0.9689770009610872
3421,Spider,5808941,1642483,4166458,2002,0.2827508490790318,0.7172491509209682
3422,Phillauri,5805030,467596,5337434,2017,0.08055014358237597,0.919449856417624
3423,Strange Gardens,5793539,78668,5714871,2003,0.013578574339449515,0.9864214256605505
3424,Phoenix,5793245,3184472,2608773,2014,0.5496870924671752,0.4503129075328249
3425,The Wizard of Oz 2013 3D/IMAX Release,5787802,5633202,154600,2013,0.9732886508557135,0.026711349144286554
3426,Dylan Dog: Dead of Night,5782515,1186538,4595977,2011,0.20519410671654115,0.7948058932834589
3427,The Skeleton Twins,5776640,5284309,492331,2014,0.9147720820407711,0.08522791795922889
3428,Untold Scandal,5762801,63332,5699469,2004,0.010989794719616381,0.9890102052803836
3429,The Good Thief,5756945,3517797,2239148,2003,0.6110527371722329,0.38894726282776715
3430,Thorns,5753991,1041228,4712763,2002,0.18095753017340485,0.8190424698265951
3431,The Golden Bowl,5753678,3050532,2703146,2001,0.5301881683333687,0.4698118316666313
3432,Nicotina,5751007,1117864,4633143,2003,0.19437708909065837,0.8056229109093416
3433,The Disappointments Room,5745040,2423468,3321572,2016,0.42183657555038784,0.5781634244496122
3434,Under the Skin,5735963,2614251,3121712,2014,0.4557649691952336,0.5442350308047663
3435,The Devil's Double,5728213,1361512,4366701,2011,0.2376852955712366,0.7623147044287634
3436,Kingsglaive: Final Fantasy XV,5725482,269980,5455502,2016,0.04715410859731984,0.9528458914026802
3437,Furie,5717640,594788,5122852,2019,0.10402683624712294,0.895973163752877
3438,Like for Likes,5715555,50839,5664716,2016,0.008894849231614427,0.9911051507683856
3439,Saaho,5708522,2872057,2836465,2019,0.5031174444103045,0.4968825555896956
3440,My Best Friend's Wedding,5707770,78578,5629192,2016,0.013766847648030668,0.9862331523519693
3441,The Viral Factor,5687319,220496,5466823,2012,0.03876976128822737,0.9612302387117726
3442,Wish I Was Here,5670776,3591299,2079477,2014,0.6332993932400081,0.36670060675999194
3443,Mission Mangal,5667057,3659413,2007644,2019,0.6457342850089561,0.35426571499104387
3444,Anomalisa,5659286,3759286,1900000,2015,0.6642686020816053,0.3357313979183946
3445,Incident in a Ghostland,5643957,0,5643957,2018,0.0,1.0
3446,Things to Come,5638693,388140,5250553,2016,0.0688351006164017,0.9311648993835983
3447,Wazir,5633588,1124045,4509543,2016,0.19952559541095302,0.800474404589047
3448,Dalida,5623134,3465,5619669,2017,0.0006162044155447833,0.9993837955844552
3449,Mother and Child,5621971,1110509,4511462,2010,0.19753019003477607,0.802469809965224
3450,Solitary Man,5615390,4360548,1254842,2010,0.7765352005826843,0.22346479941731562
3451,El Angel,5604680,109608,5495072,2018,0.01955651348515883,0.9804434865148411
3452,The Party,5597950,749827,4848123,2017,0.13394671263587563,0.8660532873641243
3453,A Fish Tale,5595327,563911,5031416,2001,0.10078249224754872,0.8992175077524512
3454,Fathers & Daughters,5587709,0,5587709,2015,0.0,1.0
3455,The French Minister,5586646,12027,5574619,2013,0.0021528122598066892,0.9978471877401933
3456,Destroyer,5580940,1533324,4047616,2018,0.2747429644468495,0.7252570355531506
3457,Pawn Sacrifice,5578519,2436633,3141886,2014,0.4367885096384901,0.56321149036151
3458,Knock Knock,5567103,36336,5530767,2015,0.00652691354911163,0.9934730864508884
3459,Dheepan,5562575,261819,5300756,2014,0.047067949645622754,0.9529320503543772
3460,Escobar: Paradise Lost,5552496,195792,5356704,2014,0.03526197947733776,0.9647380205226622
3461,Ek Tha Tiger,5543117,2347774,3195343,2012,0.42354761770318033,0.5764523822968196
3462,Last Cab to Darwin,5543036,34193,5508843,2015,0.006168641156218361,0.9938313588437816
3463,Black & White,5541431,5277299,264132,2000,0.9523350556922932,0.0476649443077068
3464,The Child,5507396,651941,4855455,2005,0.11837554444968185,0.8816244555503182
3465,On My Way,5505705,317324,5188381,2013,0.057635489006403355,0.9423645109935966
3466,Warriors of the Dawn,5497176,84532,5412644,2017,0.015377350115768533,0.9846226498842314
3467,Tale of Tales,5497104,118925,5378179,2015,0.021634118619549492,0.9783658813804506
3468,A Wizard's Tale,5487261,2150,5485111,2018,0.0003918166094158816,0.9996081833905841
3469,People I Know,5484302,126793,5357509,2002,0.023119259296807505,0.9768807407031925
3470,Made,5480653,5313300,167353,2001,0.9694647699827009,0.030535230017299034
3471,Chalet Girl,5468650,1710,5466940,2011,0.00031269143207190075,0.9996873085679281
3472,Man of Tai Chi,5464885,100144,5364741,2013,0.018324996774863513,0.9816750032251365
3473,Thank You,5452347,463540,4988807,2011,0.08501659927367058,0.9149834007263294
3474,OK Jaanu,5445281,355922,5089359,2017,0.0653633852871872,0.9346366147128128
3475,Hara-Kiri: Death of a Samurai,5435358,75688,5359670,2011,0.013925117719936755,0.9860748822800632
3476,An Inconvenient Sequel: Truth to Power,5433926,3496795,1937131,2017,0.6435117077413274,0.3564882922586726
3477,Devdas,5427830,2745382,2682448,2002,0.5057973444267783,0.49420265557322174
3478,Harry Potter and the Sorcerer's Stone 2018 Re-release,5415704,295917,5119787,2018,0.05464054165441833,0.9453594583455817
3479,The Salt of the Earth,5412189,1343349,4068840,2014,0.24820807255622448,0.7517919274437755
3480,The Student and Mister Henri,5411932,761,5411171,2015,0.00014061521837303203,0.999859384781627
3481,Dolls,5405725,4067,5401658,2002,0.000752350517275666,0.9992476494827244
3482,Lady Macbeth,5401447,1129408,4272039,2017,0.2090936002889596,0.7909063997110404
3483,Read My Lips,5393526,1471911,3921615,2001,0.2729032918354338,0.7270967081645662
3484,Exit Through the Gift Shop,5386242,3291250,2094992,2010,0.6110475541202939,0.3889524458797061
3485,Truth,5383097,2541854,2841243,2015,0.4721917513282781,0.5278082486717218
3486,After the Storm,5382886,272132,5110754,2016,0.05055503683340126,0.9494449631665988
3487,Won't Back Down,5378228,5310554,67674,2012,0.9874170451680367,0.012582954831963242
3488,Equilibrium,5359645,1203794,4155851,2002,0.22460330861465638,0.7753966913853436
3489,Intruders,5348049,69136,5278913,2011,0.01292733106970411,0.9870726689302959
3490,The Real Cancun,5345083,3825421,1519662,2003,0.7156897282979516,0.2843102717020484
3491,Much Ado About Nothing,5341221,4328849,1012372,2013,0.8104605669752291,0.18953943302477091
3492,Trollhunter,5341098,253444,5087654,2010,0.04745166630531775,0.9525483336946823
3493,Sky on fire,5335450,78366,5257084,2016,0.014687795781049395,0.9853122042189506
3494,He Loves Me... He Loves Me Not,5324097,1011102,4312995,2002,0.18991051440272408,0.8100894855972759
3495,Charlotte Gray,5323109,741394,4581715,2001,0.139278380360049,0.860721619639951
3496,The Meddler 2016 Re-release,5294643,4267218,1027425,2016,0.80595008955278,0.19404991044721995
3497,Don't Let Go,5288011,5215062,72949,2019,0.9862048320247443,0.013795167975255724
3498,The In Crowd,5280035,5280035,0,2000,1.0,0.0
3499,Talaash,5277766,2871956,2405810,2012,0.5441612985494241,0.45583870145057587
3500,Mustang,5274664,845464,4429200,2015,0.16028774534264173,0.8397122546573582
3501,Glitter,5271666,4274407,997259,2001,0.8108265963738978,0.18917340362610227
3502,True Story,5261595,4719695,541900,2015,0.8970084166493241,0.10299158335067599
3503,Nathalie...,5254422,31008,5223414,2004,0.0059013151208639125,0.9940986848791361
3504,The Biggest Little Farm,5248412,4366949,881463,2019,0.8320514852873593,0.1679485147126407
3505,Kick,5233794,2472695,2761099,2014,0.4724479029935072,0.5275520970064929
3506,The Dancer Upstairs,5227348,2377348,2850000,2002,0.4547904597130323,0.5452095402869677
3507,Tucker and Dale vs Evil,5224938,223838,5001100,2010,0.042840316956871065,0.9571596830431289
3508,Kill the Messenger,5218973,2450846,2768127,2014,0.4696031192343781,0.5303968807656219
3509,The New Girlfriend,5215796,146754,5069042,2014,0.028136453189503578,0.9718635468104965
3510,The Truth,5215649,2777,5212872,2019,0.000532436135943964,0.999467563864056
3511,Mountains May Depart,5210160,82913,5127247,2015,0.015913714741965696,0.9840862852580343
3512,Zindagi Na Milegi Dobara,5192743,3108485,2084258,2011,0.5986209985743566,0.4013790014256434
3513,Atanarjuat: The Fast Runner,5188289,3789952,1398337,2002,0.7304820529465494,0.26951794705345056
3514,Oldboy,5186767,2193658,2993109,2013,0.422933592351459,0.577066407648541
3515,Intermission,5175215,896993,4278222,2003,0.17332477974345029,0.8266752202565497
3516,My Wife Is an Actress,5169438,1121233,4048205,2001,0.2168964982266931,0.7831035017733069
3517,The House of Mirth,5164404,3043284,2121120,2000,0.5892807766394729,0.4107192233605272
3518,MI-5,5161464,0,5161464,2015,0.0,1.0
3519,October Baby 2012 Re-release,5157886,5157886,0,2012,1.0,0.0
3520,Grind,5141166,5123696,17470,2003,0.9966019381595537,0.003398061840446311
3521,Rabbit Hole,5140925,2229058,2911867,2010,0.43359084211498905,0.566409157885011
3522,Forrest Gump 2019 Re-release,5140828,203088,4937740,2019,0.03950492021907755,0.9604950797809224
3523,The Legend of Chupacabras,5138140,0,5138140,2016,0.0,1.0
3524,My Spy,5126062,0,5126062,2020,0.0,1.0
3525,Trolls World Tour,5121198,0,5121198,2020,0.0,1.0
3526,Never Look Away,5105444,1304042,3801402,2018,0.25542185948959584,0.7445781405104042
3527,The Professor and the Madman,5105195,0,5105195,2019,0.0,1.0
3528,In the Fade,5104991,321011,4783980,2017,0.06288179548210761,0.9371182045178924
3529,"Good Day, Ramon",5104868,154356,4950512,2014,0.030237020820126984,0.969762979179873
3530,Action Point,5103663,5059608,44055,2018,0.9913679645384109,0.008632035461589058
3531,Serena,5092129,176391,4915738,2014,0.03463993154925965,0.9653600684507403
3532,Dark Places,5090852,208588,4882264,2014,0.04097310234121911,0.9590268976587809
3533,Locke,5090608,1375769,3714839,2014,0.2702563230168184,0.7297436769831815
3534,The Liberator,5082098,113067,4969031,2014,0.02224809517644091,0.9777519048235591
3535,The Sense of an Ending,5081495,1274420,3807075,2017,0.2507962715696857,0.7492037284303144
3536,Dogman,5080147,148225,4931922,2018,0.029177305302385936,0.9708226946976141
3537,Anthropoid,5079219,2964845,2114374,2016,0.583720646815977,0.416279353184023
3538,L'auberge espagnole 2003 Re-release,5079086,2830361,2248725,2003,0.5572579397159253,0.44274206028407476
3539,Konosuba!: God's Blessing on This Wonderful World! - Legend of Crimson,5078942,1134786,3944156,2019,0.22342960403958148,0.7765703959604185
3540,Doctor Who: The Day of the Doctor,5074950,0,5074950,2013,0.0,1.0
3541,Stand Up Guys,5072654,3310031,1762623,2013,0.652524497038434,0.3474755029615661
3542,Mr. X,5061387,44995,5016392,2015,0.008889855685803121,0.9911101443141969
3543,Monsters,5060438,237301,4823137,2010,0.04689337168047509,0.9531066283195249
3544,The Proposition,5048693,1903434,3145259,2005,0.37701519977546666,0.6229848002245334
3545,Table 19,5042014,3614896,1427118,2017,0.7169547724381566,0.28304522756184336
3546,The Fog of War: Eleven Lessons from the Life of Robert S. McNamara,5038841,4198566,840275,2003,0.8332404217557172,0.16675957824428275
3547,Kedi,5037923,2835047,2202876,2017,0.562741232845361,0.4372587671546389
3548,Breathe,5026154,490131,4536023,2017,0.09751611271759679,0.9024838872824033
3549,Oranges and Sunshine,5017653,143480,4874173,2011,0.028595042343502033,0.9714049576564979
3550,Double Lover,5012423,167581,4844842,2017,0.03343313204013309,0.9665668679598669
3551,Worlds Apart,5011560,60298,4951262,2015,0.012031782518816496,0.9879682174811835
3552,Bubble Boy,5007898,5007898,0,2001,1.0,0.0
3553,Blindspotting,5006989,4333394,673595,2018,0.8654690473655924,0.13453095263440762
3554,Alien 2003 Director's Cut,4999112,1986910,3012202,2003,0.39745258757955415,0.6025474124204458
3555,Hands of Stone,4978353,4712792,265561,2016,0.9466568561932028,0.053343143806797146
3556,Take This Waltz,4965950,1239692,3726258,2012,0.24963843776115346,0.7503615622388465
3557,Swiss Army Man,4935501,4210454,725047,2016,0.8530955621323955,0.14690443786760451
3558,Nymphomaniac: Vol. II,4934725,327167,4607558,2014,0.06629893256463126,0.9337010674353687
3559,Sgt. Stubby: An American Hero,4932694,4015935,916759,2018,0.8141463873493876,0.18585361265061243
3560,The Anniversary Party,4931888,4047329,884559,2001,0.8206449538189026,0.17935504618109738
3561,From Justin to Kelly,4928883,4928883,0,2003,1.0,0.0
3562,Desierto,4924990,2002036,2922954,2016,0.4065055969656791,0.5934944030343209
3563,[REC] 4: Apocalypse,4915757,837,4914920,2014,0.00017026879074779326,0.9998297312092522
3564,Samson,4873825,4719928,153897,2018,0.9684237739352561,0.03157622606474381
3565,The Young Karl Marx,4870373,125659,4744714,2017,0.02580069329392225,0.9741993067060778
3566,No Man's Land,4858869,1012153,3846716,2001,0.20831041133234915,0.7916895886676508
3567,Into Great Silence,4857107,790452,4066655,2005,0.16274131906091424,0.8372586809390857
3568,Silmido,4855181,298347,4556834,2004,0.06144920240872585,0.9385507975912741
3569,Enron: The Smartest Guys in the Room,4854164,4071700,782464,2005,0.8388056110176747,0.16119438898232527
3570,Water,4842898,2250329,2592569,2005,0.46466578482553217,0.5353342151744679
3571,90 Minutes in Heaven,4842699,4842699,0,2015,1.0,0.0
3572,RamLeela,4840059,2738863,2101196,2013,0.565873887074517,0.4341261129254829
3573,Jimmy's Hall,4825184,560592,4264592,2014,0.11618043995835185,0.8838195600416482
3574,Predestination,4824499,68372,4756127,2014,0.014171834215324742,0.9858281657846752
3575,Capital,4822849,101700,4721149,2012,0.021087120911311964,0.9789128790886881
3576,Mazinger Z: INFINITY,4812371,220682,4591689,2017,0.04585722921196225,0.9541427707880378
3577,Trash,4809022,17484,4791538,2014,0.00363566646191263,0.9963643335380874
3578,Robot & Frank,4806423,3325038,1481385,2012,0.6917905477732609,0.3082094522267391
3579,Burke and Hare,4791599,4833,4786766,2010,0.0010086403307121485,0.9989913596692879
3580,Ultimate X: The Movie,4786084,4197492,588592,2002,0.8770201275197008,0.12297987248029914
3581,A Royal Night Out,4779170,228136,4551034,2015,0.04773548545040247,0.9522645145495975
3582,Martha Marcy May Marlene,4778439,2990625,1787814,2011,0.6258581515846493,0.3741418484153507
3583,Whipped,4775009,4159986,615023,2000,0.8711996144928732,0.1288003855071268
3584,Men & Chicken,4765472,30207,4735265,2015,0.00633872153692226,0.9936612784630777
3585,Force,4763946,0,4763946,2011,0.0,1.0
3586,Slack Bay,4734494,112621,4621873,2016,0.023787336091248612,0.9762126639087514
3587,The Magdalene Sisters 2003 Re-release,4734466,4583889,150577,2003,0.9681955684125728,0.03180443158742718
3588,The Double,4729855,137921,4591934,2011,0.02915966768537302,0.970840332314627
3589,Clouds of Sils Maria,4728401,1851517,2876884,2014,0.3915735996164454,0.6084264003835546
3590,The Other Side of Heaven,4720371,4720371,0,2001,1.0,0.0
3591,Sweet Bean,4720010,124800,4595210,2015,0.026440621947834857,0.9735593780521652
3592,A Housekeeper,4719781,467288,4252493,2002,0.09900628863923983,0.9009937113607601
3593,Girl in Progress,4709246,2609412,2099834,2012,0.5541039903203188,0.4458960096796812
3594,Held Up,4705631,4705631,0,2000,1.0,0.0
3595,"Jeff, Who Lives at Home",4704757,4269426,435331,2012,0.9074700351155225,0.09252996488447757
3596,Unlocked,4699125,0,4699125,2017,0.0,1.0
3597,Menteur,4697364,4697364,0,2019,1.0,0.0
3598,Jay and Silent Bob Reboot,4691248,4589490,101758,2019,0.9783089702356388,0.02169102976436121
3599,Bodyguard,4690492,1834384,2856108,2011,0.3910856259855043,0.6089143740144957
3600,Keith Lemon: The Film,4682943,0,4682943,2012,0.0,1.0
3601,The Runaways,4681651,3573673,1107978,2010,0.7633360538835552,0.2366639461164448
3602,The Woodsman,4678405,1576231,3102174,2004,0.33691632084011536,0.6630836791598846
3603,Lovely & Amazing,4677852,4222923,454929,2002,0.9027483126871051,0.0972516873128949
3604,Warriors of the Rainbow: Seediq Bale I,4670432,136166,4534266,2011,0.029154904728299225,0.9708450952717008
3605,Where to Invade Next,4664756,3827261,837495,2016,0.8204632782507809,0.17953672174921903
3606,Don't Come Knocking,4663501,440793,4222708,2005,0.09451976101216661,0.9054802389878334
3607,A Simple Life,4663094,191826,4471268,2012,0.041137064790029966,0.95886293520997
3608,Tubelight,4650456,930058,3720398,2017,0.19999286091514468,0.8000071390848553
3609,Blood and Bones,4649617,0,4649617,2004,0.0,1.0
3610,Rize,4646889,3336391,1310498,2005,0.717983795179958,0.28201620482004197
3611,Gemma Bovery,4644525,191533,4452992,2014,0.04123844741927323,0.9587615525807268
3612,Everybody Wants Some!!,4644472,3400278,1244194,2016,0.7321129290907556,0.26788707090924435
3613,Dear White People,4633961,4404154,229807,2014,0.9504080850054629,0.04959191499453707
3614,Killer Joe,4633668,1987762,2645906,2012,0.428982395803929,0.5710176041960711
3615,Hamlet 2018 Re-release,4630718,235229,4395489,2018,0.050797522112121705,0.9492024778878783
3616,Atlas Shrugged: Part I,4627375,4627375,0,2011,1.0,0.0
3617,Heneral Luna,4625639,206040,4419599,2015,0.044543035027160574,0.9554569649728394
3618,Housefull 4,4624936,2109160,2515776,2019,0.4560409052146884,0.5439590947853116
3619,Bad Samaritan,4623836,3435047,1188789,2018,0.742899834682718,0.257100165317282
3620,A Hidden Life,4614219,1730597,2883622,2019,0.3750574040807339,0.624942595919266
3621,The Last Black Man in San Francisco,4607017,4515719,91298,2019,0.9801828384831226,0.019817161516877405
3622,Whitney,4605123,3026351,1578772,2018,0.6571705033720054,0.3428294966279945
3623,The Guilty,4598051,207140,4390911,2018,0.04504952206924195,0.954950477930758
3624,The Book of Henry,4596705,4504974,91731,2017,0.9800441838229775,0.019955816177022453
3625,Tortilla Soup,4574762,4467615,107147,2001,0.9765786722894,0.023421327710600025
3626,Labyrinth of Lies,4574756,794452,3780304,2014,0.17365997224770022,0.8263400277522998
3627,Find a Boyfriend for My Wife... PLEASE!,4570757,1741889,2828868,2016,0.38109420387038734,0.6189057961296127
3628,The Beach Bum,4554416,3502600,1051816,2019,0.7690557911266779,0.23094420887332207
3629,The Iceman,4552970,1969193,2583777,2013,0.432507352343635,0.567492647656365
3630,The Keys to the House,4537451,0,4537451,2004,0.0,1.0
3631,Colossal,4531320,3029287,1502033,2017,0.6685219759363717,0.33147802406362825
3632,Cezanne et Moi,4529583,257597,4271986,2016,0.05686991495685144,0.9431300850431485
3633,Maps to the Stars,4510934,350741,4160193,2014,0.07775352066778188,0.9222464793322181
3634,"Juliet, Naked",4508260,3444895,1063365,2018,0.7641296198533358,0.23587038014666412
3635,Simon and the Oaks,4505573,150664,4354909,2011,0.03343947595566646,0.9665605240443336
3636,Barfi!,4490134,2804874,1685260,2012,0.6246748983437911,0.3753251016562089
3637,Bullhead,4483147,151840,4331307,2011,0.03386906563625953,0.9661309343637404
3638,The Wall,4476705,1803064,2673641,2017,0.4027658735610231,0.5972341264389769
3639,Woman at War,4474828,847495,3627333,2018,0.18939163695230296,0.810608363047697
3640,Batman: The Killing Joke,4462034,3775000,687034,2016,0.8460267223423219,0.1539732776576781
3641,Flypaper,4453634,5043,4448591,2011,0.0011323337301628288,0.9988676662698371
3642,Buck,4448728,4038912,409816,2011,0.9078801850776221,0.09211981492237781
3643,In Harm's Way,4447734,0,4447734,2017,0.0,1.0
3644,Mental,4446852,17669,4429183,2012,0.003973372624049553,0.9960266273759505
3645,Walk on Water,4444265,2713932,1730333,2004,0.6106593553714731,0.38934064462852686
3646,Leviathan,4439481,1092800,3346681,2014,0.24615489963804327,0.7538451003619567
3647,The Return,4429093,504256,3924837,2003,0.11385084937254648,0.8861491506274535
3648,Swift,4428275,0,4428275,2019,0.0,1.0
3649,Samsara,4426444,2672413,1754031,2012,0.6037381247791681,0.3962618752208319
3650,The Assassination of Richard Nixon,4426087,708776,3717311,2004,0.1601360298611392,0.8398639701388608
3651,Safety Not Guaranteed,4424699,4010957,413742,2012,0.906492622436012,0.09350737756398797
3652,Don't Think Twice,4417667,4417667,0,2016,1.0,0.0
3653,Laurel Canyon,4412203,3663356,748847,2003,0.8302782079609664,0.16972179203903356
3654,The Commune,4410339,38737,4371602,2016,0.008783225053675013,0.991216774946325
3655,Thérèse,4408087,101944,4306143,2012,0.02312658529652432,0.9768734147034757
3656,When Harry Met Sejal,4407775,1664648,2743127,2017,0.37766174543845815,0.6223382545615418
3657,The Tao of Steve,4406030,4342203,63827,2000,0.9855137164295296,0.014486283570470469
3658,On the Line,4403019,4365455,37564,2001,0.9914685809895437,0.008531419010456235
3659,The Eagle Huntress,4400140,3169351,1230789,2016,0.7202841273232216,0.27971587267677844
3660,360,4396975,100343,4296632,2012,0.02282091665292616,0.9771790833470738
3661,Kabali,4388789,3903095,485694,2016,0.8893330255794936,0.11066697442050644
3662,White Elephant,4387907,8884,4379023,2012,0.0020246554906473632,0.9979753445093527
3663,Clown,4381603,55007,4326596,2014,0.012554081234653163,0.9874459187653468
3664,Brian Banks,4376819,4376819,0,2019,1.0,0.0
3665,Seven Days in Utopia,4373074,4373074,0,2011,1.0,0.0
3666,There Be Dragons,4372642,1069334,3303308,2011,0.24455100600506513,0.7554489939949349
3667,Mark Felt: The Man Who Brought Down the White House,4372130,768946,3603184,2017,0.17587445935962562,0.8241255406403744
3668,Demolition,4366460,1978592,2387868,2016,0.4531341177979416,0.5468658822020585
3669,King of Devil's Island,4360391,7615,4352776,2010,0.0017464030175275566,0.9982535969824724
3670,Blinky Bill the Movie,4344536,0,4344536,2015,0.0,1.0
3671,Standing Tall,4323120,26144,4296976,2015,0.006047484224356484,0.9939525157756435
3672,Please Give,4313829,4033574,280255,2010,0.9350333543587379,0.06496664564126209
3673,Uri: The Surgical Strike 2019 Re-release,4302454,4186168,116286,2019,0.9729721689063963,0.02702783109360379
3674,Soul Survivors,4299141,3111545,1187596,2001,0.7237596999028411,0.27624030009715894
3675,The Grand Seduction,4292517,3430018,862499,2014,0.7990691708384614,0.20093082916153857
3676,High-Rise,4286576,346472,3940104,2016,0.08082721500796906,0.9191727849920309
3677,Caterina in the Big City,4285937,296464,3989473,2003,0.0691713387294307,0.9308286612705693
3678,The Other Side of Hope,4282973,183943,4099030,2017,0.042947503988467826,0.9570524960115322
3679,Storm Boy,4281218,71760,4209458,2018,0.016761585137687454,0.9832384148623126
3680,Mohabbatein,4279351,1070000,3209351,2000,0.25003791462770875,0.7499620853722913
3681,Linda Ronstadt: The Sound of My Voice,4252657,4252657,0,2019,1.0,0.0
3682,Men with Brooms,4245870,4245870,0,2002,1.0,0.0
3683,Santa vs. the Snowman 3D 2004 Re-release,4243755,1926034,2317721,2004,0.4538513651235757,0.5461486348764243
3684,Heaven,4243537,784399,3459138,2002,0.18484556632827756,0.8151544336717225
3685,"Don't Worry, He Won't Get Far on Foot",4241656,1441705,2799951,2018,0.3398920138738266,0.6601079861261734
3686,"Good Morning, Night",4234655,10093,4224562,2003,0.002383429110517858,0.9976165708894822
3687,Branded,4227984,353513,3874471,2012,0.08361266267800446,0.9163873373219955
3688,Left Behind: The Movie,4224065,4224065,0,2001,1.0,0.0
3689,Fearless 2,4216988,2519190,1697798,2012,0.5973908391487004,0.40260916085129955
3690,The Rabbi's Cat,4208573,23392,4185181,2011,0.005558178508487319,0.9944418214915127
3691,Diplomacy,4207242,230880,3976362,2014,0.05487680528003856,0.9451231947199614
3692,Let the Sunshine In,4192590,892421,3300169,2017,0.2128567305651161,0.7871432694348839
3693,Sheep & Wolves,4190750,0,4190750,2016,0.0,1.0
3694,Song of the Sea,4190670,857522,3333148,2014,0.20462646784404404,0.795373532155956
3695,Evelyn,4186916,1487645,2699271,2002,0.3553080596792484,0.6446919403207516
3696,Tanu Weds Manu Returns,4180081,3043479,1136602,2015,0.7280909149846618,0.2719090850153382
3697,Changing Times,4178714,545255,3633459,2004,0.13048392400149902,0.869516075998501
3698,East Is East,4177818,4177818,0,2000,1.0,0.0
3699,Nitro Circus: The Movie,4174269,3377618,796651,2012,0.8091519736749117,0.1908480263250883
3700,Welcome to Collinwood,4172703,336620,3836083,2002,0.08067192896307261,0.9193280710369274
3701,Krrish 3,4170204,2191534,1978670,2013,0.5255220128319862,0.47447798716801387
3702,The Guardians,4167608,177331,3990277,2017,0.04254982714305184,0.9574501728569481
3703,Dil Dhadakne Do,4161630,3066100,1095530,2015,0.7367545889471193,0.26324541105288074
3704,A Quiet Passion,4159246,1865396,2293850,2016,0.44849378949934676,0.5515062105006533
3705,King's Ransom,4143652,4008527,135125,2005,0.9673898773352588,0.03261012266474115
3706,Edison,4143414,0,4143414,2005,0.0,1.0
3707,Savage,4140502,74491,4066011,2019,0.01799081367428394,0.9820091863257161
3708,The Last Princess,4135255,29259,4105996,2016,0.007075500785320373,0.9929244992146796
3709,Ghost Stories,4131358,148747,3982611,2018,0.03600438403062625,0.9639956159693738
3710,Apartment 143,4126744,383,4126361,2012,9.280924622414184e-05,0.9999071907537759
3711,Arctic 2019 Re-release,4124015,2410795,1713220,2019,0.5845747408775186,0.41542525912248135
3712,Carancho,4120012,85526,4034486,2010,0.02075867740191048,0.9792413225980895
3713,The Fall of the American Empire,4110928,2178460,1932468,2018,0.5299192785667859,0.4700807214332141
3714,Naam Hai Akira,4108063,219401,3888662,2016,0.05340740879582421,0.9465925912041758
3715,The Hero,4101699,4077333,24366,2017,0.9940595348415376,0.005940465158462384
3716,Harry Potter and the Prisoner of Azkaban 2018 Re-release,4097066,218774,3878292,2018,0.053397724127460966,0.946602275872539
3717,Japanese Story,4095954,647054,3448900,2003,0.15797394209016996,0.8420260579098301
3718,Force Majeure,4094339,1359497,2734842,2014,0.3320430965779824,0.6679569034220175
3719,The White Countess,4092682,1669971,2422711,2005,0.4080382986022369,0.5919617013977632
3720,American Animals,4080073,2856954,1223119,2018,0.700221295060162,0.2997787049398381
3721,Katti Batti,4079135,364932,3714203,2015,0.08946308469810389,0.9105369153018961
3722,Capturing the Friedmans,4076990,3119113,957877,2003,0.7650528944147521,0.23494710558524795
3723,Bossa Nova,4069261,1823297,2245964,2000,0.4480658773177734,0.5519341226822265
3724,The Visual Bible: The Gospel of John,4069090,4069090,0,2003,1.0,0.0
3725,Grizzly Man,4061305,3178403,882902,2005,0.7826063297388401,0.2173936702611599
3726,From Prada to Nada,4058694,3033623,1025071,2011,0.7474382153471043,0.25256178465289575
3727,2 Days in New York,4058113,633210,3424903,2012,0.15603557614093053,0.8439644238590694
3728,The Killer Inside Me,4050140,217277,3832863,2010,0.053646787518456154,0.9463532124815438
3729,Film Stars Don't Die in Liverpool,4047917,1026124,3021793,2017,0.2534943280704619,0.7465056719295381
3730,Love in the Buff,4045381,256451,3788930,2012,0.06339353450268342,0.9366064654973165
3731,Step Into Liquid,4041588,3681803,359785,2003,0.9109792982362378,0.08902070176376216
3732,Metropolis,4035192,722932,3312260,2002,0.17915677866133756,0.8208432213386625
3733,Housefull 2,4035090,1791780,2243310,2012,0.44404957510241405,0.555950424897586
3734,Schultze Gets the Blues,4034232,595071,3439161,2004,0.14750539879709446,0.8524946012029055
3735,Junglee,4033587,295784,3737803,2019,0.07333026410487738,0.9266697358951226
3736,Rare Exports,4028971,236347,3792624,2010,0.05866187669258478,0.9413381233074152
3737,Vulgaria,4028543,59059,3969484,2012,0.014660138913746235,0.9853398610862537
3738,Jeepers Creepers III,4017852,2335162,1682690,2017,0.5811966194872284,0.4188033805127715
3739,A Perfect Day,4009440,14044,3995396,2015,0.0035027335488247734,0.9964972664511752
3740,Penguin Highway,4006647,104567,3902080,2018,0.026098381015347744,0.9739016189846522
3741,Faces Places,3998450,953717,3044733,2017,0.23852167714989558,0.7614783228501044
3742,Sleight,3989705,3986245,3460,2017,0.999132767961541,0.0008672320384589838
3743,The Invisible Woman,3986888,1234254,2752634,2013,0.3095782976597286,0.6904217023402714
3744,Le petit lieutenant,3984265,216724,3767541,2005,0.054394976237775346,0.9456050237622247
3745,The Nile Hilton Incident,3979536,81089,3898447,2017,0.02037649615432553,0.9796235038456744
3746,Ip Man: The Final Fight,3967001,37884,3929117,2013,0.009549783324985298,0.9904502166750146
3747,Lucifer,3956978,0,3956978,2019,0.0,1.0
3748,The Devil's Violinist,3952097,11294,3940803,2013,0.002857723380777344,0.9971422766192226
3749,Bully 2012 Re-release,3950244,3863446,86798,2012,0.978027180093179,0.021972819906820946
3750,2:22,3945729,422,3945307,2017,0.00010695108559153454,0.9998930489144084
3751,Breakfast on Pluto,3942254,828699,3113555,2005,0.2102094385597681,0.7897905614402319
3752,Terminator 2: Judgment Day 2017 Re-release,3931111,1037809,2893302,2017,0.2639989051441183,0.7360010948558817
3753,Ride Your Wave,3927015,332432,3594583,2019,0.08465259236341088,0.9153474076365891
3754,Welcome to the Punch,3926386,9747,3916639,2013,0.002482435501756577,0.9975175644982435
3755,Loveless,3925992,566356,3359636,2017,0.1442580626756244,0.8557419373243756
3756,Indignation,3924527,3401155,523372,2016,0.86664074422217,0.13335925577783003
3757,Mrs. Palfrey at the Claremont,3919275,1720953,2198322,2005,0.43909983351512716,0.5609001664848728
3758,A Private War,3915207,1633208,2281999,2018,0.4171447384518877,0.5828552615481123
3759,The To Do List,3909596,3491669,417927,2013,0.8931022540436403,0.10689774595635969
3760,The Starving Games,3906308,0,3906308,2013,0.0,1.0
3761,Taxi,3906227,321642,3584585,2015,0.08234083682284721,0.9176591631771528
3762,Camping sauvage,3900099,3894585,5514,2004,0.9985861897351836,0.0014138102648163548
3763,The Wall,3889260,38674,3850586,2012,0.009943793935093051,0.990056206064907
3764,Osama,3888902,1270904,2617998,2003,0.32680278392204276,0.6731972160779572
3765,Rules Don't Apply,3885342,3652206,233136,2016,0.9399960157947486,0.06000398420525143
3766,Neruda,3884746,939101,2945645,2016,0.2417406440472556,0.7582593559527444
3767,The Perfect Game,3878993,1037071,2841922,2010,0.26735572866463025,0.7326442713353698
3768,"The Night Is Short, Walk on Girl",3878208,406490,3471718,2017,0.10481387279898345,0.8951861272010165
3769,Django,3876874,56556,3820318,2017,0.014588041808941946,0.9854119581910581
3770,Horns,3875442,173948,3701494,2014,0.044884686701542685,0.9551153132984573
3771,Submarine,3875173,467602,3407571,2011,0.1206660967136177,0.8793339032863823
3772,First Reformed,3862498,3448256,414242,2018,0.8927528247263817,0.10724717527361827
3773,Lan Yu,3847964,116325,3731639,2001,0.030230272424586094,0.9697697275754139
3774,Frozen,3843774,246176,3597598,2010,0.06404538872472731,0.9359546112752727
3775,Marley,3842919,1413480,2429439,2012,0.36781415377217164,0.6321858462278284
3776,To Save a Life,3824868,3777210,47658,2010,0.9875399621634001,0.012460037836599852
3777,2001: A Space Odyssey 2017 Re-release,3823450,3236321,587129,2017,0.8464399952922099,0.15356000470779008
3778,Elles,3822241,157508,3664733,2012,0.04120828592440927,0.9587917140755907
3779,The Other Son,3820405,1285918,2534487,2012,0.3365920628833854,0.6634079371166146
3780,The Homesman,3819421,2429989,1389432,2014,0.6362192070473509,0.3637807929526491
3781,Benji: Off the Leash!,3817362,3817362,0,2004,1.0,0.0
3782,Brad's Status,3816527,2133158,1683369,2017,0.558926479493005,0.441073520506995
3783,Green Street Hooligans,3814717,346830,3467887,2005,0.09091893317381079,0.9090810668261892
3784,Sweet 20,3810429,71775,3738654,2015,0.01883646172123926,0.9811635382787607
3785,Better Luck Tomorrow,3809226,3802390,6836,2003,0.998205409707904,0.0017945902920960845
3786,Custody,3790303,83882,3706421,2018,0.022130684538940553,0.9778693154610595
3787,The Paperboy,3783865,693286,3090579,2012,0.18322165299237683,0.8167783470076232
3788,Donnie Darko 2004 Director's Cut,3782231,753147,3029084,2004,0.19912771060255177,0.8008722893974483
3789,Citizenfour,3780692,2800870,979822,2014,0.7408352756585302,0.25916472434146975
3790,Green Room,3769214,3220371,548843,2016,0.8543879440116693,0.1456120559883307
3791,The Secret Lives of Dentists,3764286,3707346,56940,2003,0.984873625436537,0.015126374563463031
3792,Before the Fall,3764219,144254,3619965,2005,0.038322424917360015,0.96167757508264
3793,Kings & Queen,3761583,290973,3470610,2004,0.0773538693682952,0.9226461306317048
3794,Black Sea,3758103,1171559,2586544,2014,0.3117421209583665,0.6882578790416335
3795,The Trip,3741198,2030962,1710236,2011,0.542864077228738,0.457135922771262
3796,Take Shelter,3741098,1730296,2010802,2011,0.46251020422346595,0.5374897957765341
3797,Up at the Villa,3740113,2933161,806952,2000,0.7842439519875469,0.2157560480124531
3798,Like Crazy,3731489,3395391,336098,2011,0.9099292534427945,0.09007074655720544
3799,The Big Kahuna,3728888,3165544,563344,2000,0.8489243978365668,0.1510756021634332
3800,Ragnarok,3721345,1369,3719976,2013,0.00036787774312782074,0.9996321222568721
3801,Free Fire,3719383,1799312,1920071,2017,0.4837662590811433,0.5162337409188567
3802,Summertime,3719031,35322,3683709,2015,0.009497635271123043,0.990502364728877
3803,Night of 7 Years,3716820,24281,3692539,2018,0.006532734972368853,0.9934672650276312
3804,Thirteen Conversations About One Thing,3706652,3288164,418488,2002,0.8870981144169995,0.1129018855830005
3805,The Last King,3705618,8905,3696713,2016,0.0024031079296354886,0.9975968920703645
3806,A Fantastic Woman,3702353,2020988,1681365,2017,0.5458658318102029,0.4541341681897971
3807,Spare Parts,3701281,3618912,82369,2015,0.9777458128685718,0.02225418713142828
3808,Crush,3695710,1084935,2610775,2002,0.29356605361351407,0.7064339463864859
3809,Western Stars,3681681,1581681,2100000,2019,0.4296083772602787,0.5703916227397213
3810,1911,3680151,135739,3544412,2011,0.03688408437588566,0.9631159156241144
3811,Gosnell: The Trial of America's Biggest Serial Killer,3679893,3679893,0,2018,1.0,0.0
3812,5 Flights Up,3679847,1020921,2658926,2015,0.2774357194742064,0.7225642805257936
3813,Love Crime,3663918,539792,3124126,2010,0.1473264412576919,0.8526735587423081
3814,Ju-on: The Grudge,3657876,325680,3332196,2003,0.08903527620947238,0.9109647237905276
3815,"Lucía, Lucía",3653588,269586,3384002,2003,0.07378664479957783,0.9262133552004221
3816,Nicholas Nickleby,3651462,1587173,2064289,2002,0.4346678125090717,0.5653321874909283
3817,Number One Fan,3650598,15549,3635049,2014,0.004259302174602627,0.9957406978253974
3818,Non-Fiction,3649042,704919,2944123,2018,0.19317919607392844,0.8068208039260716
3819,The Cat's Meow,3646994,3209481,437513,2002,0.8800346257767356,0.11996537422326442
3820,A la mala,3646627,3629842,16785,2015,0.9953971162940438,0.0046028837059562165
3821,Hedwig and the Angry Inch,3644200,3067312,576888,2001,0.8416969430876461,0.15830305691235388
3822,Celeste & Jesse Forever,3640975,3094813,546162,2012,0.84999567423561,0.15000432576439005
3823,Bhoot,3640472,106774,3533698,2003,0.029329713289925043,0.9706702867100749
3824,The German Doctor,3635718,418392,3217326,2013,0.11507823214011648,0.8849217678598835
3825,Sweet Sixteen,3633509,316319,3317190,2002,0.08705606618835952,0.9129439338116405
3826,Crooked House,3625952,0,3625952,2017,0.0,1.0
3827,Colonia,3621046,15709,3605337,2016,0.004338249224119219,0.9956617507758808
3828,The Last Circus,3604598,40548,3564050,2010,0.011248965904103592,0.9887510340958964
3829,Everything Is Illuminated,3601974,1712337,1889637,2005,0.4753884953084059,0.5246115046915941
3830,The Insult,3601603,1001305,2600298,2017,0.2780164832159458,0.7219835167840543
3831,Phoenix Forgotten,3600146,3600146,0,2017,1.0,0.0
3832,Heart Blackened,3593480,37047,3556433,2017,0.010309504992375079,0.989690495007625
3833,Badla,3590894,1861000,1729894,2019,0.5182553425414396,0.48174465745856043
3834,Indivisible,3589633,3511417,78216,2018,0.9782105858732634,0.02178941412673663
3835,Agneepath,3582446,1986748,1595698,2012,0.5545786314713467,0.4454213685286533
3836,Ghostbusters 30th Anniversary Release,3580343,3580343,0,2014,1.0,0.0
3837,Lemming,3580017,81698,3498319,2005,0.022820562025264127,0.9771794379747358
3838,Paradise Now,3579902,1457843,2122059,2005,0.40722986271691236,0.5927701372830876
3839,The Apparition,3562793,28293,3534500,2018,0.007941241604550137,0.9920587583954499
3840,2 States,3558887,2238174,1320713,2014,0.6288971804949132,0.37110281950508683
3841,Les Boys III,3557100,3557100,0,2001,1.0,0.0
3842,Price of Glory,3548556,3440228,108328,2000,0.9694726531017124,0.030527346898287643
3843,The Oscar Nominated Short Films 2019: Documentary,3538550,3531094,7456,2019,0.9978929222421613,0.0021070777578386627
3844,Catfish,3533711,3237343,296368,2010,0.9161312286149037,0.0838687713850963
3845,Ek Ladki Ko Dekha Toh Aisa Laga,3531837,1182636,2349201,2019,0.33485010774846063,0.6651498922515393
3846,Born Into Brothels: Calcutta's Red Light Kids,3529201,3515061,14140,2004,0.9959934274075067,0.004006572592493315
3847,Sidewalks of New York,3520373,2402652,1117721,2001,0.6824992692535706,0.3175007307464294
3848,The Riot Club,3517925,7734,3510191,2014,0.0021984550551816767,0.9978015449448183
3849,The Oscar Nominated Short Films 2018: Live Action,3511123,3508777,2346,2018,0.9993318377054863,0.0006681622945137496
3850,Head in the Clouds,3510605,398278,3112327,2004,0.11344996090417464,0.8865500390958254
3851,Ladrones,3504414,3063505,440909,2015,0.8741846711033571,0.12581532889664293
3852,Thanks for Sharing,3499442,1065881,2433561,2013,0.3045859882804173,0.6954140117195827
3853,Faustina: Love and Mercy,3498887,2243180,1255707,2019,0.6411124451861406,0.35888755481385937
3854,Maiden,3495241,3168978,326263,2019,0.9066550775754805,0.09334492242451951
3855,Wild Target,3494154,108589,3385565,2010,0.031077336602794266,0.9689226633972058
3856,Where the Truth Lies,3487678,872142,2615536,2005,0.2500637960270415,0.7499362039729585
3857,Veronica Mars: The Movie,3485383,3322127,163256,2014,0.9531598105574051,0.04684018944259497
3858,3,3484446,59954,3424492,2010,0.01720617854316009,0.9827938214568399
3859,Jack and the Cuckoo-Clock Heart,3484370,0,3484370,2014,0.0,1.0
3860,Miles Ahead,3473958,2610896,863062,2016,0.7515623389804943,0.2484376610195057
3861,Great Performances at the Met: Puccini: Tosca,3473616,2023749,1449867,2018,0.5826058493512236,0.4173941506487764
3862,The Aeronauts,3472708,0,3472708,2019,0.0,1.0
3863,The Method,3470651,7017,3463634,2005,0.002021810893691126,0.9979781891063089
3864,Hors la loi,3470487,96933,3373554,2010,0.027930662180840903,0.972069337819159
3865,Enemy,3468224,1008726,2459498,2014,0.2908479959771918,0.7091520040228082
3866,The Long Weekend,3467374,1286,3466088,2005,0.00037088586348054753,0.9996291141365194
3867,Bacurau,3463910,58115,3405795,2019,0.016777283474455167,0.9832227165255448
3868,Til Death Do Us Part,3455267,3455267,0,2017,1.0,0.0
3869,Obsession,3454709,528799,2925910,2016,0.1530661482631388,0.8469338517368612
3870,Separate Lies,3452023,924260,2527763,2005,0.2677444501383681,0.7322555498616319
3871,Racetime,3439053,1875283,1563770,2018,0.5452905203845361,0.45470947961546393
3872,Words and Pictures,3438874,2171257,1267617,2014,0.63138602926423,0.3686139707357699
3873,Full Frontal,3438804,2512846,925958,2002,0.7307325453849652,0.26926745461503476
3874,A Gentleman,3438746,410055,3028691,2017,0.11924550402966663,0.8807544959703334
3875,The Rider,3434963,2419031,1015932,2018,0.7042378622418931,0.29576213775810684
3876,2001: A Space Odyssey 2001 Re-release,3434270,239621,3194649,2001,0.06977348898019084,0.9302265110198091
3877,He Named Me Malala,3433606,2668936,764670,2015,0.7772982689335934,0.22270173106640656
3878,Borg vs. McEnroe,3430165,231346,3198819,2017,0.06744456899303677,0.9325554310069633
3879,Disconnect,3428048,1436900,1991148,2013,0.41915982506662686,0.5808401749333731
3880,Special Forces,3424648,10759,3413889,2011,0.0031416367463167017,0.9968583632536833
3881,Next Time I'll Aim for the Heart,3418213,815,3417398,2014,0.00023842867603627977,0.9997615713239637
3882,The Cave of the Yellow Dog,3417511,141803,3275708,2005,0.04149306322642414,0.9585069367735759
3883,Midnight Diner,3412771,18555,3394216,2019,0.005436930869372718,0.9945630691306273
3884,3-Iron,3403957,241914,3162043,2004,0.07106846531845144,0.9289315346815485
3885,Friends 25th: The One With The Anniversary,3403406,2884827,518579,2019,0.8476294041909781,0.1523705958090219
3886,Honey Boy,3400977,3012615,388362,2019,0.8858086955601288,0.11419130443987124
3887,The Protector 2,3399790,2463,3397327,2013,0.000724456510549181,0.9992755434894508
3888,Junebug,3399228,2678691,720537,2005,0.7880292231059522,0.2119707768940477
3889,The Good Lie,3396345,2722209,674136,2014,0.8015113305627078,0.19848866943729215
3890,Rock the Kasbah,3394174,3020664,373510,2015,0.889955553250953,0.11004444674904704
3891,"All's Well, Ends Well 2012",3390232,47919,3342313,2012,0.014134430918002072,0.985865569081998
3892,Gauguin: Voyage to Tahiti,3389322,200140,3189182,2017,0.059050158114218716,0.9409498418857812
3893,Anything for Alice,3387582,1092,3386490,2014,0.00032235382051268427,0.9996776461794873
3894,Apartment 1303 3D,3377891,0,3377891,2012,0.0,1.0
3895,The Neon Demon,3377430,1333124,2044306,2016,0.39471550853755666,0.6052844914624433
3896,Red Satin,3375341,231879,3143462,2002,0.06869794785178741,0.9313020521482126
3897,The King's Speech PG-13 Version,3375215,3344306,30909,2011,0.9908423611532895,0.009157638846710506
3898,The Hole in the Ground,3373474,21072,3352402,2019,0.006246379844634937,0.9937536201553651
3899,Bunty Aur Babli,3370142,942756,2427386,2005,0.2797377677261077,0.7202622322738923
3900,Sunshine State,3369654,3065921,303733,2002,0.9098622588550634,0.09013774114493654
3901,Patrick the Pug,3369468,6290,3363178,2018,0.0018667635365582935,0.9981332364634417
3902,We Don't Live Here Anymore,3361213,2041014,1320199,2004,0.6072254272490318,0.39277457275096817
3903,Echo in the Canyon,3355324,3355324,0,2019,1.0,0.0
3904,Reality,3350996,72577,3278419,2012,0.021658336804937995,0.978341663195062
3905,The Work and the Glory,3347647,3347647,0,2004,1.0,0.0
3906,Supercross,3344431,3102550,241881,2005,0.9276764866729198,0.07232351332708015
3907,Mistress America,3340737,2500431,840306,2015,0.7484668802123603,0.25153311978763965
3908,No News from God,3340382,77858,3262524,2002,0.023308112664958677,0.9766918873350413
3909,Machine Gun Preacher,3338690,538690,2800000,2011,0.16134771422324326,0.8386522857767568
3910,Atlas Shrugged II: The Strike,3336053,3336053,0,2012,1.0,0.0
3911,On Chesil Beach,3335913,745971,2589942,2018,0.22361824184263798,0.776381758157362
3912,The Program,3335613,13074,3322539,2015,0.003919519440654536,0.9960804805593455
3913,By the Sea,3334927,538460,2796467,2015,0.16146080558884798,0.838539194411152
3914,Raiders of the Lost Ark 2012 IMAX Release,3332854,3125613,207241,2012,0.9378187583374489,0.062181241662551075
3915,Last Ounce of Courage,3329674,3329674,0,2012,1.0,0.0
3916,Vanishing Time: A Boy Who Returned,3328517,57759,3270758,2016,0.017352773021739112,0.9826472269782609
3917,The Death & Life of John F. Donovan,3326364,152713,3173651,2019,0.04590988839465555,0.9540901116053444
3918,Obvious Child,3325417,3123963,201454,2014,0.9394199283879285,0.06058007161207151
3919,Flying Swords of Dragon Gate,3323381,170276,3153105,2011,0.051235774652379606,0.9487642253476204
3920,Breath,3322479,37108,3285371,2018,0.01116876886204548,0.9888312311379546
3921,Wildlife,3321367,1050616,2270751,2018,0.31632035845481693,0.683679641545183
3922,Pootie Tang,3313583,3313583,0,2001,1.0,0.0
3923,Chhichhore,3307350,2004400,1302950,2019,0.6060441138675979,0.39395588613240207
3924,Heist,3294317,50136,3244181,2015,0.015218936125454836,0.9847810638745451
3925,Bluff Master,3289047,722847,2566200,2005,0.21977399532448152,0.7802260046755185
3926,Wonderstruck,3285916,1060377,2225539,2017,0.32270362358623894,0.6772963764137611
3927,Good Time,3283369,2026499,1256870,2017,0.6172011126376596,0.3827988873623403
3928,Bharath Ane Nenu,3276257,2663090,613167,2018,0.8128452682436085,0.18715473175639152
3929,Pieces of April,3272028,2528664,743364,2003,0.7728124575951062,0.22718754240489383
3930,Marianne & Leonard: Words of Love,3271888,1012034,2259854,2019,0.30931193243778515,0.6906880675622148
3931,Chicken With Plums,3265941,253874,3012067,2011,0.077733798620367,0.922266201379633
3932,Clifford's Really Big Movie,3255426,2922354,333072,2004,0.8976871229756106,0.10231287702438943
3933,Bilal: A New Breed of Hero,3254027,0,3254027,2016,0.0,1.0
3934,Little Fish,3248506,8148,3240358,2005,0.0025082299370849247,0.9974917700629151
3935,Queens,3245067,140417,3104650,2005,0.04327090935256499,0.956729090647435
3936,Your Sister's Sister,3242802,1636190,1606612,2012,0.5045605621311446,0.4954394378688554
3937,In Harmony,3242445,3144,3239301,2015,0.0009696386523133006,0.9990303613476867
3938,The Front Runner,3242235,2000105,1242130,2018,0.616890817599588,0.3831091824004121
3939,Sleeping with Other People,3224947,819431,2405516,2015,0.25409130754706977,0.7459086924529302
3940,The Final Cut,3222439,551281,2671158,2004,0.1710756976315145,0.8289243023684855
3941,Love is in the Air 2013 Re-release,3221554,8425,3213129,2013,0.0026151975102698885,0.9973848024897302
3942,Gun Shy,3221280,1638202,1583078,2000,0.5085562260964586,0.49144377390354144
3943,The Wild Parrots of Telegraph Hill,3218709,3058527,160182,2005,0.950234084535135,0.04976591546486495
3944,Embrace of the Serpent,3217176,1329249,1887927,2015,0.41317260852374876,0.5868273914762512
3945,The Mystery of Happiness,3216374,8528,3207846,2014,0.0026514329490289375,0.9973485670509711
3946,Riding Giants,3216111,2276368,939743,2004,0.7078014409328534,0.29219855906714665
3947,6 Souls,3205167,0,3205167,2010,0.0,1.0
3948,Saint Laurent,3202241,429477,2772764,2014,0.13411763824146902,0.865882361758531
3949,Tadpole,3200241,2891288,308953,2002,0.9034594582095536,0.09654054179044641
3950,I,3200113,1449232,1750881,2015,0.4528690080631528,0.5471309919368472
3951,Dear Zindagi,3199581,2376479,823102,2016,0.7427469409275778,0.2572530590724223
3952,Fill the Void,3197615,1775316,1422299,2012,0.5552000475354287,0.44479995246457127
3953,Victoria,3191971,0,3191971,2015,0.0,1.0
3954,Empire of Lust,3191168,10654,3180514,2015,0.003338589507039429,0.9966614104929605
3955,Machuca,3187700,26676,3161024,2004,0.008368416099382,0.991631583900618
3956,Thoroughbreds,3187255,3072605,114650,2018,0.9640286076890616,0.03597139231093841
3957,Showtime Championship Boxing: Floyd Mayweather vs. Conor McGregor,3184384,2620183,564201,2017,0.822822561600611,0.17717743839938901
3958,Strayed,3184020,482757,2701263,2003,0.15161870842519834,0.8483812915748017
3959,Madame 2017 Re-release,3182153,90979,3091174,2017,0.028590391473948613,0.9714096085260514
3960,Tea With the Dames,3181152,889343,2291809,2018,0.2795663332025631,0.7204336667974369
3961,Pastorela,3179022,161194,3017828,2011,0.05070553144960935,0.9492944685503907
3962,Waking Life,3176880,2901447,275433,2001,0.9133007856765128,0.08669921432348719
3963,Pilgrim's Progress,3173282,1294596,1878686,2019,0.4079675238443983,0.5920324761556017
3964,Rosewater,3171593,3128941,42652,2014,0.9865518684143899,0.013448131585610134
3965,Songcatcher,3171273,3059834,111439,2001,0.9648598528098968,0.03514014719010315
3966,Beautiful,3169930,3157348,12582,2000,0.996030827179149,0.003969172820850933
3967,Land of Mine,3169553,435266,2734287,2015,0.1373272508773319,0.8626727491226681
3968,Race 2,3164441,1579940,1584501,2013,0.4992793355919734,0.5007206644080265
3969,The Bridesmaid,3162662,111728,3050934,2004,0.03532720221130174,0.9646727977886983
3970,The Lodge,3154127,2138907,1015220,2020,0.6781296377729876,0.32187036222701243
3971,Ingrid Goes West,3146831,3024308,122523,2017,0.9610646393149171,0.03893536068508287
3972,The Last Full Measure,3145875,2949212,196663,2020,0.9374854372789765,0.06251456272102356
3973,Genesis,3139313,16413,3122900,2004,0.005228213943623971,0.9947717860563761
3974,Munna Bhai M.B.B.S.,3137716,48772,3088944,2003,0.015543790451398407,0.9844562095486016
3975,The Deep Blue Sea,3115609,1126525,1989084,2011,0.3615745749867843,0.6384254250132158
3976,In a World...,3114953,2963902,151051,2013,0.9515077755587323,0.048492224441267655
3977,Close Encounters of the Third Kind 2017 Re-release,3101507,3100479,1028,2017,0.9996685482251048,0.00033145177489523643
3978,Come Undone,3101465,10035,3091430,2010,0.003235567707518866,0.9967644322924811
3979,Raw,3096815,514870,2581945,2017,0.16625791337228735,0.8337420866277127
3980,Paid in Full,3090862,3090862,0,2002,1.0,0.0
3981,Aquarius,3085977,285930,2800047,2016,0.09265461148932737,0.9073453885106726
3982,The People Vs. Fritz Bauer,3083973,288483,2795490,2015,0.09354264774691608,0.9064573522530839
3983,Mumbai Diaries,3082958,576639,2506319,2011,0.1870408224828233,0.8129591775171767
3984,Incantato,3082196,108954,2973242,2003,0.03534947161050109,0.9646505283894989
3985,3 Hearts,3077754,161129,2916625,2014,0.052352787129835585,0.9476472128701644
3986,Ismael's Ghosts,3075562,102510,2973052,2017,0.03333049374390762,0.9666695062560924
3987,Living Is Easy with Eyes Closed,3075169,11600,3063569,2013,0.003772150408644208,0.9962278495913558
3988,The End of the Tour,3072991,3002884,70107,2015,0.9771860705091554,0.022813929490844587
3989,Jane Got a Gun,3067531,1513793,1553738,2015,0.49348906335420895,0.506510936645791
3990,English Vinglish,3064818,1862086,1202732,2012,0.6075682144910399,0.3924317855089601
3991,'71,3062178,1270847,1791331,2014,0.4150140847462166,0.5849859152537834
3992,Remember,3054936,547009,2507927,2015,0.1790574336090838,0.8209425663909162
3993,Mambo Italiano,3047296,3047296,0,2003,1.0,0.0
3994,La moustache,3044771,244771,2800000,2005,0.08039061065676203,0.919609389343238
3995,The Mother,3039587,1063163,1976424,2003,0.349772189445474,0.6502278105545259
3996,Harrison's Flowers,3033646,1871025,1162621,2002,0.6167578550694445,0.38324214493055553
3997,Innocence,3026796,2202382,824414,2001,0.7276281586205348,0.2723718413794653
3998,Starred Up,3025189,54915,2970274,2014,0.018152584846764946,0.981847415153235
3999,G,3020784,3020784,0,2005,1.0,0.0
4000,The Greatest Miracle,3019382,555166,2464216,2011,0.18386742717549484,0.8161325728245051
4001,All Is True,3019143,1200481,1818662,2019,0.3976231003301268,0.6023768996698732
4002,Top Gun 2013 3D Release,3018873,3018873,0,2013,1.0,0.0
4003,Rigor Mortis,3016904,7865,3009039,2013,0.0026069772190298397,0.9973930227809702
4004,Cowboy Bebop: The Movie,3007903,1000045,2007858,2003,0.3324724899705875,0.6675275100294125
4005,The Second Mother,3003560,376986,2626574,2015,0.1255130578380322,0.8744869421619678
4006,Isn't She Great,3003296,2962465,40831,2000,0.9864046034756481,0.013595396524351912
4007,The Imposter,3001877,898317,2103560,2012,0.2992517681437314,0.7007482318562686
4008,Made for More,2999134,2999134,0,2018,1.0,0.0
4009,Pinocchio Italian Version,2995810,8586,2987224,2003,0.002866002850648072,0.9971339971493519
4010,The Corporation 2004 Re-release,2992149,1879983,1112166,2004,0.6283052749044249,0.3716947250955751
4011,Elsa & Fred,2985837,189024,2796813,2005,0.06330687174149158,0.9366931282585084
4012,The Last Word,2982004,1783421,1198583,2017,0.5980612366717147,0.40193876332828526
4013,Darwin's Nightmare,2981713,203746,2777967,2005,0.06833186158426381,0.9316681384157361
4014,Memoir of War,2980982,103636,2877346,2018,0.034765724851743486,0.9652342751482565
4015,Love Is Strange 2014 Re-release,2979739,2262223,717516,2014,0.759201728742014,0.24079827125798603
4016,Clean,2971219,138711,2832508,2004,0.046684879169122166,0.9533151208308779
4017,Romeo and Juliet,2966268,1162635,1803633,2013,0.39195210951943654,0.6080478904805634
4018,Donnie Darko,2962988,517375,2445613,2001,0.17461258702363966,0.8253874129763603
4019,The Last: Naruto the Movie,2949185,524451,2424734,2015,0.17782912906447035,0.8221708709355297
4020,Shattered Glass,2944752,2220008,724744,2003,0.7538862355811288,0.24611376441887126
4021,Fearless,2942554,1288549,1654005,2010,0.4379015644232867,0.5620984355767132
4022,Filly Brown,2940411,2850357,90054,2013,0.9693736691911436,0.030626330808856312
4023,Joan Rivers: A Piece of Work,2930687,2930687,0,2010,1.0,0.0
4024,The Lord of the Rings: The Fellowship of the Ring 2003 Extended Edition,2928554,1412056,1516498,2002,0.48216833290422506,0.5178316670957749
4025,Kites,2924751,1643486,1281265,2010,0.5619233910852582,0.4380766089147418
4026,My Architect,2920081,2750707,169374,2003,0.9419968144719273,0.05800318552807268
4027,Sylvia,2917393,1315498,1601895,2003,0.45091559484786586,0.5490844051521341
4028,Brighton Rock,2913599,229653,2683946,2011,0.07882107318131287,0.9211789268186872
4029,Letters to God,2908893,2848578,60315,2010,0.9792653081429946,0.020734691857005397
4030,Bright Young Things,2905499,933637,1971862,2003,0.3213344764530981,0.6786655235469019
4031,Time to Leave,2893462,117686,2775776,2005,0.040673076059060044,0.95932692394094
4032,The East,2891812,2301839,589973,2013,0.7959850087073433,0.20401499129265666
4033,The Oscar Nominated Short Films 2017: Live Action,2877797,2835355,42442,2017,0.9852519131822015,0.014748086817798475
4034,Starbuck,2865068,340058,2525010,2011,0.11869107469700545,0.8813089253029945
4035,Home Run,2861020,2861020,0,2013,1.0,0.0
4036,And Now Ladies & Gentlemen,2860785,736872,2123913,2002,0.25757685390548396,0.742423146094516
4037,The Flowers of War,2855644,311434,2544210,2012,0.10905911241037047,0.8909408875896295
4038,Inhumans,2852282,1521787,1330495,2017,0.5335331499480065,0.46646685005199345
4039,The Salt of Life,2850852,317405,2533447,2011,0.1113368915678541,0.8886631084321459
4040,The Oscar Nominated Short Films 2016: Live Action,2850840,2816816,34024,2016,0.9880652719900099,0.011934728009990039
4041,God Bless the Broken Road,2848233,2846257,1976,2018,0.9993062365333173,0.0006937634666826766
4042,All or Nothing,2845696,201546,2644150,2002,0.07082485268981648,0.9291751473101835
4043,Remember You,2845124,14814,2830310,2016,0.005206802937235776,0.9947931970627643
4044,A Breath Away,2842040,77987,2764053,2018,0.027440500485566705,0.9725594995144333
4045,The Identical,2840991,2827666,13325,2014,0.9953097352297139,0.0046902647702861434
4046,Personal Shopper,2840408,1305195,1535213,2016,0.4595096901571887,0.5404903098428113
4047,The Fluffy Movie: Unity Through Laughter,2827393,2827393,0,2014,1.0,0.0
4048,A Coffee in Berlin,2826333,150275,2676058,2012,0.05316960174190373,0.9468303982580962
4049,Everything Must Go,2820490,2711643,108847,2011,0.9614084786686001,0.03859152133139986
4050,Raising Victor Vargas,2816116,2078661,737455,2003,0.7381304605350064,0.26186953946499364
4051,Captive,2801508,2583301,218207,2015,0.9221108774274427,0.07788912257255735
4052,To the Wonder,2801166,587615,2213551,2013,0.20977514363661418,0.7902248563633858
4053,"Cinco de Mayo, La Batalla",2794852,173472,2621380,2013,0.06206840290648664,0.9379315970935134
4054,After the Wedding,2790020,1574258,1215762,2019,0.5642461344363123,0.4357538655636877
4055,Children of the Sea,2789668,0,2789668,2019,0.0,1.0
4056,Bon voyage 2004 Re-release,2788330,2354559,433771,2004,0.8444334063758594,0.1555665936241406
4057,Kirk Cameron's Saving Christmas,2783970,2783970,0,2014,1.0,0.0
4058,24 Hour Party People,2781211,1184096,1597115,2002,0.4257483520667795,0.5742516479332205
4059,Gabrielle,2775311,332829,2442482,2005,0.11992493814206769,0.8800750618579323
4060,The Wonders,2772358,73378,2698980,2014,0.026467721701165577,0.9735322782988344
4061,My Summer of Love,2766976,1000915,1766061,2004,0.3617360613174816,0.6382639386825184
4062,Comedian,2751988,2751988,0,2002,1.0,0.0
4063,Ma vie en cinémascope,2750263,2750263,0,2004,1.0,0.0
4064,Battle for Incheon: Operation Chromite,2749918,1023348,1726570,2016,0.37213764192241366,0.6278623580775863
4065,Ararat,2743336,1555959,1187377,2002,0.5671776989767203,0.4328223010232797
4066,McQueen,2739246,1257275,1481971,2018,0.4589857939009494,0.5410142060990506
4067,Edie,2731170,71790,2659380,2018,0.02628543810894232,0.9737145618910577
4068,Lucky,2728446,955925,1772521,2017,0.35035511056476837,0.6496448894352316
4069,Control Room,2724826,2589616,135210,2004,0.9503784828829437,0.049621517117056285
4070,Cocktail,2724695,1227789,1496906,2012,0.4506152064726511,0.5493847935273489
4071,The Color of Paradise,2724595,1817216,907379,2000,0.6669673841433313,0.3330326158566686
4072,Chi-Raq,2719699,2653032,66667,2015,0.9754873609175133,0.0245126390824867
4073,Billionaire Boys Club,2713955,1349,2712606,2018,0.0004970605629054277,0.9995029394370946
4074,What Maisie Knew,2711379,1066471,1644908,2013,0.3933315851454186,0.6066684148545813
4075,Factotum,2708087,808221,1899866,2005,0.2984472064597629,0.701552793540237
4076,Bobby Jones: Stroke of Genius,2707913,2694071,13842,2004,0.9948883143586962,0.005111685641303838
4077,Up and Down,2705163,245127,2460036,2004,0.09061450271203621,0.9093854972879638
4078,Auto Focus,2704951,2063196,641755,2002,0.7627480128105832,0.23725198718941673
4079,The Guest,2700051,332890,2367161,2014,0.12329026377649904,0.876709736223501
4080,Gangsterdam,2697522,954,2696568,2017,0.0003536579127065507,0.9996463420872934
4081,The Best of Youth,2693053,274024,2419029,2003,0.10175217494791228,0.8982478250520878
4082,Jiro Dreams of Sushi,2692864,2552478,140386,2012,0.9478674006559559,0.05213259934404411
4083,Thérèse: The Story of Saint Thérèse of Lisieux,2689828,2627016,62812,2004,0.976648321007886,0.023351678992113992
4084,A Hijacking,2688444,414437,2274007,2012,0.15415496845015184,0.8458450315498481
4085,Intimacy,2672527,405094,2267433,2001,0.1515771402870766,0.8484228597129234
4086,In Your Name,2663172,0,2663172,2003,0.0,1.0
4087,The Cup,2660645,0,2660645,2011,0.0,1.0
4088,Diego Maradona,2656890,0,2656890,2019,0.0,1.0
4089,Camp,2650356,1629862,1020494,2003,0.6149596507035281,0.38504034929647185
4090,Hillsong: Let Hope Rise,2649761,2394386,255375,2016,0.9036233833919362,0.0963766166080639
4091,Twelve,2648195,183920,2464275,2010,0.06945107894244948,0.9305489210575505
4092,Pioneer,2647820,6871,2640949,2013,0.0025949649145334654,0.9974050350854665
4093,Stories We Tell,2641053,1600145,1040908,2013,0.6058738692483642,0.39412613075163583
4094,God's Army,2637726,2637726,0,2000,1.0,0.0
4095,Kinky Boots: The Musical,2635571,900451,1735120,2019,0.34165309908175495,0.658346900918245
4096,Beautiful Accident,2632092,51766,2580326,2017,0.01966724567378344,0.9803327543262166
4097,Maniac,2631275,31081,2600194,2012,0.011812144302666958,0.988187855697333
4098,Third Person,2624761,1021398,1603363,2014,0.3891394302185989,0.610860569781401
4099,Below,2622015,605562,2016453,2002,0.23095291216869468,0.7690470878313053
4100,The Happy Prince,2621992,466440,2155552,2018,0.17789527961946489,0.8221047203805351
4101,Happy End,2610794,301718,2309076,2017,0.11556560954253764,0.8844343904574624
4102,The Little Mermaid,2610742,147175,2463567,2018,0.05637286258082951,0.9436271374191705
4103,Russian Ark Canadian Release,2610711,684034,1926677,2003,0.2620106170311459,0.7379893829688541
4104,Poster Boys,2602256,97049,2505207,2017,0.03729417858965452,0.9627058214103454
4105,Zero,2595762,1035388,1560374,2018,0.39887632225142367,0.6011236777485763
4106,N-Secure,2595644,2595644,0,2010,1.0,0.0
4107,The Signal,2595622,600896,1994726,2014,0.23150366270589476,0.7684963372941053
4108,But I'm a Cheerleader,2595216,2205627,389589,2000,0.849881859544639,0.15011814045536095
4109,It's Easier for a Camel...,2590219,16150,2574069,2003,0.006234994029462373,0.9937650059705376
4110,Leo Da Vinci: Mission Mona Lisa,2588859,19978,2568881,2018,0.007716913126593608,0.9922830868734064
4111,A Question of Faith,2587072,2587072,0,2017,1.0,0.0
4112,Blancanieves,2585522,279735,2305787,2012,0.10819285235244566,0.8918071476475543
4113,Assassination Nation,2584988,2005142,579846,2018,0.7756871598630245,0.2243128401369755
4114,Metallica & San Francisco Symphony - S&M2,2582847,1252385,1330462,2019,0.4848854771498273,0.5151145228501727
4115,The Informer,2579970,0,2579970,2019,0.0,1.0
4116,The Gatekeepers,2573616,2415727,157889,2013,0.9386509098482446,0.06134909015175535
4117,Is Genesis History?,2570392,2570392,0,2017,1.0,0.0
4118,Maquia: When the Promised Flower Blooms 2018 Re-release,2569927,18539,2551388,2018,0.007213823583315791,0.9927861764166842
4119,Blood Ties,2566435,42472,2523963,2013,0.016549026178336874,0.9834509738216631
4120,Young Adam,2561820,767373,1794447,2003,0.2995421223973581,0.7004578776026419
4121,God's Own Country,2559939,335609,2224330,2017,0.1311003895014686,0.8688996104985314
4122,Lucky Break,2559317,54606,2504711,2001,0.021336161171124954,0.9786638388288751
4123,The Only Living Boy in New York,2550321,624332,1925989,2017,0.2448052617690087,0.7551947382309914
4124,"1,000 Times Good Night",2549568,53895,2495673,2013,0.021138875291814144,0.9788611247081859
4125,Disney's Newsies: The Broadway Musical!,2545060,2545060,0,2017,1.0,0.0
4126,The Dinner,2544921,1323312,1221609,2017,0.5199815632783886,0.4800184367216114
4127,El Jeremías,2540144,650465,1889679,2016,0.25607406509237274,0.7439259349076273
4128,In the Name of My Daughter,2537899,277528,2260371,2014,0.10935344550748473,0.8906465544925153
4129,Novocaine,2534372,2036682,497690,2001,0.8036239352391835,0.19637606476081648
4130,IN OUR HANDS: Battle for Jerusalem,2534370,2534370,0,2017,1.0,0.0
4131,Poetry,2533089,356149,2176940,2010,0.14059869195278965,0.8594013080472104
4132,Spirits in the Forest,2531785,704744,1827041,2019,0.2783585494028916,0.7216414505971084
4133,Bucky Larson: Born to Be a Star,2530394,2529395,999,2011,0.9996051998226363,0.00039480017736368326
4134,Coincidence,2520487,298032,2222455,2017,0.11824381558008433,0.8817561844199157
4135,Restless,2518012,163265,2354747,2011,0.06483884906029042,0.9351611509397095
4136,Birds of Passage,2517405,507259,2010146,2018,0.2015007517662037,0.7984992482337963
4137,Fateless,2512009,196857,2315152,2005,0.07836635935619657,0.9216336406438034
4138,LBJ,2510151,2470979,39172,2017,0.9843945643110713,0.015605435688928674
4139,The Rover,2510007,1114423,1395584,2014,0.44399198886696334,0.5560080111330367
4140,Grace Unplugged,2507201,2507201,0,2013,1.0,0.0
4141,I'm in Love with a Church Girl,2503392,2387730,115662,2013,0.953797887026882,0.046202112973118076
4142,The Queen of Versailles,2495706,2401999,93707,2012,0.9624527087725878,0.037547291227412204
4143,Still Life,2495025,9481,2485544,2013,0.0037999619242292163,0.9962000380757707
4144,Look Both Ways,2490011,105067,2384944,2005,0.04219539592395375,0.9578046040760463
4145,"One Nation, One King",2481681,6576,2475105,2018,0.0026498167975658434,0.9973501832024342
4146,Cairo Time,2477315,1603616,873699,2010,0.6473201833436604,0.35267981665633963
4147,The Christmas Candle,2476775,2258620,218155,2013,0.9119197343319437,0.08808026566805624
4148,Grease 2018 Re-release,2469213,1213413,1255800,2018,0.4914169008505949,0.5085830991494051
4149,Wonderland,2466444,1060512,1405932,2003,0.42997611135707925,0.5700238886429208
4150,Bamboozled,2463650,2274979,188671,2000,0.9234180991618127,0.07658190083818724
4151,Last Days,2456454,463080,1993374,2005,0.1885156408383792,0.8114843591616208
4152,Painted Skin: The Resurrection,2455359,50425,2404934,2012,0.020536711739505303,0.9794632882604947
4153,Tees Maar Khan,2454414,1076443,1377971,2010,0.43857433994427997,0.56142566005572
4154,The Endurance,2453083,2453083,0,2001,1.0,0.0
4155,Piku,2452343,1801807,650536,2015,0.7347287879387182,0.2652712120612818
4156,Crime Spree,2451607,0,2451607,2003,0.0,1.0
4157,Footnote,2451259,2007758,443501,2011,0.819072158429607,0.18092784157039302
4158,The Tree,2450045,71158,2378887,2010,0.029043548179727312,0.9709564518202727
4159,Côte d'Azur,2447211,141039,2306172,2005,0.057632545783751384,0.9423674542162486
4160,Love at First Fight,2446362,25229,2421133,2014,0.010312864571964411,0.9896871354280355
4161,Lean on Pete,2443584,1163056,1280528,2018,0.47596317540137767,0.5240368245986223
4162,Highwaymen,2442378,371396,2070982,2004,0.15206327603671504,0.847936723963285
4163,Coriolanus,2435325,757195,1678130,2012,0.31092154024616836,0.6890784597538316
4164,The Unknown Girl,2432640,150549,2282091,2016,0.061887085635359114,0.9381129143646408
4165,Joe,2431443,373375,2058068,2014,0.15356107463757118,0.8464389253624288
4166,The Grace Card,2430735,2430735,0,2011,1.0,0.0
4167,The Breadwinner 2018 Re-release,2426907,834,2426073,2018,0.0003436472843829615,0.999656352715617
4168,Life of Riley,2423379,11616,2411763,2014,0.004793307196274293,0.9952066928037258
4169,The Matrix Reloaded 2003 IMAX Release,2423288,0,2423288,2003,0.0,1.0
4170,After.Life,2422634,108595,2314039,2010,0.044825177884897184,0.9551748221151029
4171,Adam's Apples,2421577,1305,2420272,2005,0.0005389050193324433,0.9994610949806676
4172,Hearts Beat Loud,2417165,2386251,30914,2018,0.9872106372548005,0.012789362745199439
4173,Riddle,2415975,1409499,1006476,2005,0.5834079408934281,0.4165920591065719
4174,The Art of Self-Defense,2414269,2410914,3355,2019,0.9986103454089001,0.0013896545910998318
4175,The Oscar Nominated Short Films 2015: Live Action,2412593,2412593,0,2015,1.0,0.0
4176,Beloved Sisters,2407680,54030,2353650,2014,0.022440689792663476,0.9775593102073366
4177,Sound! Euphonium the Movie - Our Promise: A Brand New Day,2403030,90341,2312689,2019,0.037594620125424985,0.962405379874575
4178,The Stroller Strategy,2401291,3462,2397829,2013,0.0014417244723775669,0.9985582755276224
4179,The Race Against Time,2395616,815064,1580552,2005,0.3402314895208581,0.6597685104791419
4180,The Man Who Killed Don Quixote,2390383,391963,1998420,2018,0.1639749780683681,0.8360250219316319
4181,Finding Vivian Maier,2384584,1514782,869802,2014,0.6352395218620942,0.3647604781379058
4182,Dark Blue World,2381183,258771,2122412,2001,0.10867329390475239,0.8913267060952477
4183,Laggies,2379154,1066981,1312173,2014,0.44847075893363775,0.5515292410663623
4184,Journey,2377609,2377609,0,2003,1.0,0.0
4185,Red Lights,2373828,673828,1700000,2004,0.2838571286546456,0.7161428713453544
4186,I Wish,2371548,145808,2225740,2011,0.06148220487209198,0.938517795127908
4187,Lore,2362019,970325,1391694,2012,0.4108032153848043,0.5891967846151958
4188,Cake,2360281,1951776,408505,2015,0.8269252686438606,0.17307473135613938
4189,Desi Boyz,2355293,1078826,1276467,2011,0.4580432243461854,0.5419567756538146
4190,Chico & Rita,2347919,350524,1997395,2010,0.14929135119226855,0.8507086488077314
4191,Memories of the Sword,2345062,111071,2233991,2015,0.047363779720962604,0.9526362202790374
4192,Standing in the Shadows of Motown,2344256,1722119,622137,2002,0.7346121754620656,0.2653878245379344
4193,Terraferma,2343302,19996,2323306,2011,0.008533257770445295,0.9914667422295547
4194,1991,2342264,2342264,0,2018,1.0,0.0
4195,Housefull,2340550,1183658,1156892,2010,0.5057178868214736,0.49428211317852644
4196,Ong-bak 3,2340516,14890,2325626,2010,0.00636184499486438,0.9936381550051356
4197,High Heels and Low Lifes,2340411,228194,2112217,2001,0.09750167812405598,0.902498321875944
4198,Gabriela,2335352,2335352,0,2001,1.0,0.0
4199,Meru,2334228,2334228,0,2015,1.0,0.0
4200,Jem and the Holograms,2333684,2184640,149044,2015,0.9361335982078122,0.0638664017921878
4201,Ready,2332914,955148,1377766,2011,0.40942272196917673,0.5905772780308233
4202,The Experiment 2002 Re-release,2327755,144634,2183121,2002,0.06213454594663098,0.937865454053369
4203,Bhaag Milkha Bhaag,2325917,1636731,689186,2013,0.7036927800949045,0.2963072199050955
4204,The Oranges,2316971,366377,1950594,2012,0.158127572593701,0.841872427406299
4205,Austenland,2313509,2159041,154468,2013,0.9332321594599373,0.06676784054006274
4206,A Aa,2313043,2313043,0,2016,1.0,0.0
4207,WARx2,2310625,2310625,0,2015,1.0,0.0
4208,The Resurrection of Gavin Stone,2308355,2303792,4563,2017,0.9980232676516394,0.001976732348360629
4209,Blackfish,2303417,2073582,229835,2013,0.900219977537719,0.09978002246228104
4210,Lost Embrace,2298732,190860,2107872,2004,0.08302838260397472,0.9169716173960253
4211,Piranhas,2298525,23494,2275031,2019,0.010221337596937167,0.9897786624030628
4212,The Remaining,2297261,1169603,1127658,2014,0.509129350126085,0.49087064987391504
4213,3 from Hell,2295825,2172949,122876,2019,0.9464784990145155,0.05352150098548452
4214,Buffalo Soldiers,2295274,354421,1940853,2002,0.15441337286964432,0.8455866271303557
4215,Ek Main Aur Ekk Tu,2293823,1155545,1138278,2012,0.5037638039203548,0.4962361960796452
4216,Going Away,2290889,19501,2271388,2014,0.008512415922377732,0.9914875840776223
4217,American Honey,2290649,663246,1627403,2016,0.28954501540829697,0.7104549845917031
4218,Noel,2280924,0,2280924,2004,0.0,1.0
4219,Escanaba in da Moonlight,2276602,2276602,0,2001,1.0,0.0
4220,RV: Resurrected Victims,2269892,20374,2249518,2017,0.008975757436917704,0.9910242425630823
4221,The House That Jack Built 2018 Re-release,2268962,87993,2180969,2018,0.03878116953919898,0.961218830460801
4222,Luce,2268204,2010613,257591,2019,0.8864339362773366,0.1135660637226634
4223,Sleepwalk with Me,2266067,2266067,0,2012,1.0,0.0
4224,Nobody Knows,2265264,684118,1581146,2004,0.30200365167150495,0.697996348328495
4225,Puzzle,2260946,2032018,228928,2018,0.8987468077521533,0.1012531922478467
4226,Dans une galaxie près de chez vous - Le film,2259688,2259688,0,2004,1.0,0.0
4227,DysFunktional Family,2255000,2255000,0,2003,1.0,0.0
4228,Shadow Dancer,2253819,100616,2153203,2012,0.04464244910527421,0.9553575508947258
4229,An Interview with God,2251795,1201434,1050361,2018,0.5335450163092111,0.4664549836907889
4230,Marius,2249781,9781,2240000,2013,0.0043475342711135,0.9956524657288865
4231,My All-American,2246000,2246000,0,2015,1.0,0.0
4232,No culpes al karma de lo que te pasa por gilipollas,2242471,5614,2236857,2016,0.0025034883394255713,0.9974965116605744
4233,At War,2235052,4605,2230447,2018,0.002060354747898483,0.9979396452521015
4234,Elena,2227905,233380,1994525,2011,0.10475312008366605,0.895246879916334
4235,Heal the Living,2223529,3176,2220353,2016,0.0014283600528709093,0.998571639947129
4236,The Lovers,2216083,2194521,21562,2017,0.9902702200233475,0.0097297799766525
4237,Bill Cunningham: New York,2210382,1510026,700356,2011,0.6831516000401741,0.31684839995982594
4238,Rivers and Tides: Andy Goldsworthy Working with Time,2200276,2200276,0,2002,1.0,0.0
4239,Goodnight Mommy,2193474,1178196,1015278,2015,0.5371369799687619,0.46286302003123814
4240,3 Faces,2191516,72324,2119192,2018,0.033001812443988546,0.9669981875560114
4241,What Will People Say,2191131,44156,2146975,2017,0.020152149734543486,0.9798478502654565
4242,Maria By Callas 2018 Re-release,2185562,1267301,918261,2018,0.5798513151308451,0.4201486848691549
4243,Don't Say Anything,2185360,224831,1960529,2003,0.10288053226928287,0.8971194677307172
4244,Anchorman 2: The Legend Continues R-Rated Extended Cut,2185255,2184339,916,2014,0.9995808269515457,0.0004191730484542994
4245,Border,2177678,771930,1405748,2018,0.35447389375288724,0.6455261062471127
4246,Gone with the Wind 2019 Re-release,2176120,2176120,0,2019,1.0,0.0
4247,Veere Di Wedding,2176099,0,2176099,2018,0.0,1.0
4248,Desire,2174005,301010,1872995,2003,0.13845874319516285,0.8615412568048372
4249,The Oscar Nominated Short Films 2014: Live Action,2171849,2171849,0,2014,1.0,0.0
4250,Henry's Crime,2169799,102541,2067258,2011,0.04725829443188056,0.9527417055681194
4251,The Reluctant Fundamentalist,2167020,552959,1614061,2013,0.25517023377726095,0.7448297662227391
4252,The Benefactor,2159380,0,2159380,2015,0.0,1.0
4253,Stage Beauty,2153070,782383,1370687,2004,0.36338019664943544,0.6366198033505646
4254,Shower,2150929,1157764,993165,2000,0.5382623043345457,0.4617376956654543
4255,The Saratov Approach,2146999,2146999,0,2013,1.0,0.0
4256,The Oscar Nominated Short Films 2013: Live Action,2142342,2142342,0,2013,1.0,0.0
4257,Let Yourself Go,2140190,12189,2128001,2017,0.0056952887360468,0.9943047112639533
4258,The Attack,2139516,1720325,419191,2013,0.80407204246194,0.19592795753806
4259,Thumbsucker,2138742,1328679,810063,2005,0.6212432355094724,0.3787567644905276
4260,High Life,2133033,1225852,907181,2018,0.5746990318480774,0.42530096815192264
4261,My Scientology Movie,2130866,22936,2107930,2016,0.010763698890498042,0.989236301109502
4262,Mountain,2129889,365412,1764477,2017,0.17156387022985706,0.8284361297701429
4263,Heleno,2126384,0,2126384,2012,0.0,1.0
4264,Sightseers,2122909,61782,2061127,2012,0.029102519231865333,0.9708974807681346
4265,Let There Be Victory,2122804,1264515,858289,2014,0.595681466588531,0.404318533411469
4266,Abracadabra,2114260,13975,2100285,2017,0.006609877687701608,0.9933901223122984
4267,Left Luggage,2111280,1069540,1041740,2000,0.5065836838316092,0.4934163161683907
4268,State Property,2106838,2106838,0,2002,1.0,0.0
4269,"20,000 Days on Earth",2105558,279558,1826000,2014,0.13277145535767715,0.8672285446423228
4270,The Eye of the Storm,2104689,83566,2021123,2011,0.03970467845843258,0.9602953215415674
4271,Once Upon a Time in Anatolia,2099472,152408,1947064,2011,0.07259349017276724,0.9274065098272327
4272,The Wizard of Oz 2019 Re-release,2097514,2076020,21494,2019,0.9897526309717122,0.010247369028287772
4273,Indian Horse,2097362,2097362,0,2018,1.0,0.0
4274,Mary Shelley,2096600,108900,1987700,2018,0.051941238195173135,0.9480587618048268
4275,Bollywood/Hollywood,2092228,1454510,637718,2002,0.6951966994036979,0.3048033005963021
4276,Garam Masala,2091698,1007943,1083755,2005,0.4818778810325391,0.5181221189674609
4277,The Captive,2090612,1075178,1015434,2014,0.5142886389248699,0.48571136107513013
4278,"The Butcher, the Chef, and the Swordsman",2089266,47896,2041370,2011,0.022924797512619263,0.9770752024873808
4279,Apollo 13 The IMAX Experience,2089051,1766621,322430,2002,0.8456571907531218,0.15434280924687813
4280,Waves,2088217,1658790,429427,2019,0.7943570998607903,0.20564290013920966
4281,Lost in Paris,2087225,691597,1395628,2017,0.33134760267819713,0.6686523973218029
4282,Girl Most Likely,2085617,1378591,707026,2013,0.6609991192054917,0.3390008807945083
4283,The Hard Word,2085562,426880,1658682,2002,0.20468343784553036,0.7953165621544697
4284,Summer Storm,2085166,95204,1989962,2004,0.045657755785390705,0.9543422442146093
4285,Equals,2084628,33258,2051370,2016,0.01595392559247981,0.9840460744075202
4286,High Strung,2084451,53447,2031004,2016,0.02564080422135133,0.9743591957786487
4287,I'm Not Ashamed,2082980,2082980,0,2016,1.0,0.0
4288,A Cat in Paris,2080634,309973,1770661,2010,0.1489800704977425,0.8510199295022575
4289,Wi-heom-han gyan-gye,2074864,54000,2020864,2012,0.02602580217305809,0.973974197826942
4290,Black '47,2073063,57520,2015543,2018,0.027746383009102954,0.9722536169908971
4291,Blood Simple 2000 Re-release,2068701,1701855,366846,2000,0.82266842815854,0.17733157184145992
4292,A Fool,2067820,8212,2059608,2015,0.003971332127554622,0.9960286678724454
4293,Hotchpotch 3,2067671,1132192,935479,2010,0.5475687379665334,0.4524312620334666
4294,American Pastoral,2063436,544098,1519338,2016,0.263685425668642,0.7363145743313579
4295,Battle of the Brave,2057293,1599716,457577,2004,0.7775829694652148,0.2224170305347853
4296,Under the Silver Lake,2053469,46083,2007386,2018,0.022441536736127986,0.977558463263872
4297,Family Comes First,2048588,327615,1720973,2005,0.1599223465137939,0.8400776534862061
4298,Hamlet,2046433,1577287,469146,2000,0.7707493966330684,0.22925060336693162
4299,Being 17,2045219,52713,1992506,2016,0.025773767992571944,0.9742262320074281
4300,Guzaarish,2043580,1017335,1026245,2010,0.4978200021530843,0.5021799978469157
4301,W.E.,2042203,583455,1458748,2012,0.2856988262185493,0.7143011737814507
4302,Hotchpotch Again,2041647,1013893,1027754,2017,0.49660543668910445,0.5033945633108956
4303,The Dangerous Lives of Altar Boys,2036599,1815864,220735,2002,0.8916158752901283,0.1083841247098717
4304,Raid,2031135,1010385,1020750,2018,0.49744847092881567,0.5025515290711844
4305,Climax,2027391,817339,1210052,2018,0.40314818404540614,0.5968518159545939
4306,The Work and the Glory II: American Zion,2025032,2025032,0,2005,1.0,0.0
4307,The Broken Hearts Club: A Romantic Comedy,2019121,1746585,272536,2000,0.8650224528396268,0.13497754716037325
4308,Armadillo,2018685,14566,2004119,2010,0.007215588365693509,0.9927844116343065
4309,Graduation,2015002,175975,1839027,2016,0.0873324195211717,0.9126675804788283
4310,What to Do in Case of Fire,2014162,33545,1980617,2002,0.01665456899693272,0.9833454310030673
4311,Sur le seuil,2014071,2014071,0,2003,1.0,0.0
4312,Little Men,2008649,702537,1306112,2016,0.34975598026335114,0.6502440197366489
4313,The Man from Elysian Fields,2006391,1435016,571375,2002,0.7152225064805414,0.2847774935194586
4314,Red Nose,2004814,2004814,0,2003,1.0,0.0
4315,Greater,2000093,2000093,0,2016,1.0,0.0
4316,Peterloo,1998945,151971,1846974,2018,0.07602560350584933,0.9239743964941507
4317,Will You Marry Me?,1998096,915728,1082368,2004,0.4583003018873968,0.5416996981126032
4318,1898: Our Last Men in the Philippines,1995045,2848,1992197,2016,0.001427536722229323,0.9985724632777707
4319,Antboy,1994566,0,1994566,2013,0.0,1.0
4320,Va Savoir (Who Knows?),1989779,907323,1082456,2001,0.4559918463306729,0.5440081536693271
4321,The Trip to Spain,1988841,1157604,831237,2017,0.5820495454387756,0.41795045456122437
4322,Summer 1993,1983149,185903,1797246,2017,0.0937413174703464,0.9062586825296536
4323,Great Performances at the Met: Verdi: La Traviata,1982588,1882931,99657,2018,0.9497338831870262,0.05026611681297375
4324,Metallica: Some Kind of Monster,1980444,1222708,757736,2004,0.6173908477088976,0.3826091522911024
4325,Singham Returns,1974745,1232018,742727,2014,0.6238871347946191,0.37611286520538095
4326,Beloved,1971858,137515,1834343,2011,0.06973879457851427,0.9302612054214857
4327,Diary of a Chambermaid,1971247,54235,1917012,2015,0.027513041237348743,0.9724869587626512
4328,42nd Street: The Musical,1967450,187440,1780010,2019,0.09527052784060586,0.9047294721593941
4329,Maquia: When the Promised Flower Blooms,1963575,185699,1777876,2018,0.09457189055676508,0.9054281094432349
4330,Menashe,1962265,1703036,259229,2017,0.8678929706232339,0.13210702937676613
4331,Cecil B. Demented,1961544,1284646,676898,2000,0.6549157194536549,0.3450842805463451
4332,Greenfingers,1961054,1443067,517987,2001,0.7358629594085629,0.26413704059143706
4333,Holy Motors,1954125,641100,1313025,2012,0.3280752254845519,0.6719247745154481
4334,Swades,1953889,1223240,730649,2004,0.626053987713734,0.373946012286266
4335,God Is Great and I'm Not,1952817,73181,1879636,2001,0.03747458159161867,0.9625254184083814
4336,A Ghost Story,1951683,1596371,355312,2017,0.8179458446889172,0.1820541553110828
4337,Deadfall,1946254,66351,1879903,2012,0.03409164476990156,0.9659083552300984
4338,Liam,1945689,1016021,929668,2001,0.5221908537284222,0.47780914627157783
4339,V/H/S,1944287,100345,1843942,2012,0.0516101789499184,0.9483898210500816
4340,Housefull 3,1944262,1326999,617263,2016,0.6825206685107255,0.3174793314892746
4341,Another Earth,1938783,1321194,617589,2011,0.6814553253252169,0.3185446746747831
4342,Monty Python and the Holy Grail 2001 Re-release,1935066,1827696,107370,2001,0.9445135204690692,0.05548647953093073
4343,Roger Dodger,1934497,1266828,667669,2002,0.6548617030680327,0.34513829693196735
4344,The House That Jack Built,1933114,170113,1763001,2018,0.08799946614633178,0.9120005338536682
4345,Luka Chuppi,1923586,1042905,880681,2019,0.5421670775312359,0.45783292246876406
4346,Jane,1921221,1723379,197842,2017,0.8970227787433096,0.10297722125669041
4347,A Dirty Shame,1914166,1339668,574498,2004,0.6998703351746922,0.30012966482530773
4348,Old Fashioned,1914090,1914090,0,2015,1.0,0.0
4349,Professor Marston & the Wonder Women,1899615,1584759,314856,2017,0.8342527301584794,0.16574726984152052
4350,Secuestro express,1898606,307208,1591398,2005,0.16180713639375416,0.8381928636062459
4351,Frank,1897363,645186,1252177,2014,0.3400435235640202,0.6599564764359799
4352,Game of Thrones Season 4 Finale,1896092,1896092,0,2015,1.0,0.0
4353,Marie Curie: The Courage of Knowledge,1892911,127986,1764925,2017,0.06761332149266394,0.932386678507336
4354,The Art of Getting By,1892130,1430241,461889,2011,0.7558893944919218,0.2441106055080782
4355,The Mighty Macs,1891936,1891936,0,2011,1.0,0.0
4356,Awake: The Life of Yogananda,1891918,1539680,352238,2014,0.8138196264320123,0.1861803735679876
4357,Red Lips,1889869,136163,1753706,2011,0.07204890921010927,0.9279510907898907
4358,Tusk,1882074,1826705,55369,2014,0.9705808592010728,0.02941914079892714
4359,Me and You,1878702,796641,1082061,2004,0.42403797941344606,0.5759620205865539
4360,Kill Your Darlings,1877924,1030064,847860,2013,0.5485120803610796,0.45148791963892043
4361,Red State,1874460,1104682,769778,2011,0.5893334613702079,0.410666538629792
4362,Wilbur Wants to Kill Himself,1873482,235294,1638188,2003,0.12559181246470477,0.8744081875352953
4363,Last Flag Flying,1872950,965481,907469,2017,0.5154867989001308,0.4845132010998692
4364,The Whistleblower,1870392,1124966,745426,2011,0.6014600147990368,0.39853998520096323
4365,Undertaking Betty,1868949,0,1868949,2002,0.0,1.0
4366,Purple Rain 2016 Re-release,1868929,1868075,854,2016,0.9995430538024719,0.000456946197528103
4367,Late Marriage,1868298,1656445,211853,2001,0.8866064193185456,0.11339358068145446
4368,The Luzhin Defence,1864747,1053070,811677,2001,0.5647254024272461,0.43527459757275383
4369,Inseparables,1864605,6258,1858347,2016,0.003356206810557732,0.9966437931894423
4370,Fantastic Fungi,1864309,1788322,75987,2019,0.9592411987497781,0.04075880125022193
4371,A Better Life,1863506,1759252,104254,2011,0.9440549158414301,0.05594508415856992
4372,Girlhood,1862990,60765,1802225,2014,0.03261692225937874,0.9673830777406213
4373,The Hallow,1862407,13906,1848501,2015,0.007466681557790537,0.9925333184422095
4374,The Dark Horse,1862114,67533,1794581,2014,0.036266845101857355,0.9637331548981426
4375,The Pact,1855647,2488,1853159,2018,0.0013407722481700453,0.9986592277518299
4376,The Five of Us,1852272,1852272,0,2004,1.0,0.0
4377,Sweet Country,1847693,104297,1743396,2018,0.056447147875756415,0.9435528521242436
4378,A Love Song for Bobby Long,1841260,164308,1676952,2004,0.0892367183341842,0.9107632816658158
4379,Elvis Gratton 3: Le retour d'Elvis Wong,1838920,1838920,0,2004,1.0,0.0
4380,Crooked Arrows,1832541,1832541,0,2012,1.0,0.0
4381,Startup.com,1830008,1283356,546652,2001,0.7012843659699848,0.29871563403001516
4382,99 Homes,1828232,1411927,416305,2015,0.7722909346297406,0.22770906537025937
4383,Enduring Love,1828184,358362,1469822,2004,0.19602075064654323,0.8039792493534568
4384,Rams,1826583,149250,1677333,2015,0.08170994693370079,0.9182900530662992
4385,A Somewhat Gentle Man,1826459,37743,1788716,2010,0.02066457555302364,0.9793354244469764
4386,Delhi Safari,1826376,0,1826376,2012,0.0,1.0
4387,The Little Stranger,1824902,713143,1111759,2018,0.39078427225133183,0.6092157277486682
4388,Mozart's Sister,1824891,707885,1117006,2010,0.3879053598269705,0.6120946401730295
4389,Infinitely Polar Bear,1824678,1430655,394023,2015,0.7840588860061884,0.21594111399381152
4390,Human Flow,1824537,527845,1296692,2017,0.28930353289629096,0.710696467103709
4391,The Seagull,1820461,1252960,567501,2018,0.688265225127042,0.311734774872958
4392,Brodeuses - A Common Thread,1812833,26042,1786791,2004,0.014365360736482622,0.9856346392635174
4393,The Monk,1809527,13472,1796055,2011,0.0074450395047987675,0.9925549604952012
4394,NSync: Bigger Than Live,1808679,1808679,0,2001,1.0,0.0
4395,The Navigators,1807686,3052,1804634,2002,0.0016883463167828925,0.9983116536832171
4396,The Other Side of Heaven 2: Fire of Faith,1807216,1807216,0,2019,1.0,0.0
4397,Moses,1807117,1807117,0,2018,1.0,0.0
4398,The Face of Love,1806548,350006,1456542,2013,0.19374298385650424,0.8062570161434958
4399,The Aura,1805261,58804,1746457,2005,0.032573683251341495,0.9674263167486585
4400,How I Killed My Father,1802142,145396,1656746,2001,0.0806795468947508,0.9193204531052492
4401,Oyster Farmer,1801199,15456,1785743,2005,0.008580950799994892,0.9914190492000051
4402,The Bridge of San Luis Rey,1800141,49981,1750160,2004,0.027765047293517562,0.9722349527064824
4403,Elvis & Nixon,1798432,1055287,743145,2016,0.5867817076208608,0.41321829237913915
4404,The Polar Express 2010 IMAX Release,1798274,672796,1125478,2010,0.3741343087872037,0.6258656912127962
4405,Mine,1788934,0,1788934,2016,0.0,1.0
4406,Mondovino,1788325,209618,1578707,2004,0.11721471209092307,0.882785287909077
4407,Soldiers of Fortune,1784286,38898,1745388,2012,0.021800316765361608,0.9781996832346384
4408,Song to Song,1778021,443684,1334337,2017,0.2495381100673164,0.7504618899326836
4409,Ondine,1777019,550472,1226547,2010,0.30977271486686414,0.6902272851331359
4410,Tom of Finland,1776931,378296,1398635,2017,0.2128929035511227,0.7871070964488773
4411,The Diary of a Teenage Girl,1775133,1477002,298131,2015,0.832051457552758,0.16794854244724197
4412,Polaroid,1772204,0,1772204,2019,0.0,1.0
4413,Dior and I,1769832,1028953,740879,2015,0.5813845607944709,0.4186154392055291
4414,I Saw the Light,1767963,1646788,121175,2016,0.9314606697085855,0.06853933029141447
4415,Carman: The Champion,1765751,1765751,0,2001,1.0,0.0
4416,Great Performances at the Met: Puccini: La Bohème,1764201,1764201,0,2018,1.0,0.0
4417,Tales of the Night,1762194,10975,1751219,2011,0.006228031646912883,0.9937719683530871
4418,Invisible Life,1759150,146535,1612615,2019,0.0832987522382969,0.9167012477617031
4419,Bloody Sunday,1758689,773228,985461,2002,0.43966158883122597,0.560338411168774
4420,The Blue Butterfly,1755355,1755355,0,2004,1.0,0.0
4421,Flipped,1755212,1755212,0,2010,1.0,0.0
4422,Going the Distance,1752950,1230897,522053,2004,0.7021860292649533,0.2978139707350466
4423,Murderball,1750211,1531154,219057,2005,0.8748396621893018,0.12516033781069824
4424,Great Performances at the Met: Massenet: Cendrillon,1747259,1243306,503953,2018,0.7115751013444487,0.2884248986555514
4425,The Debut,1745778,1745778,0,2001,1.0,0.0
4426,Beast,1744071,800365,943706,2018,0.45890620278646915,0.5410937972135309
4427,"Turn Me On, Dammit!",1743743,126085,1617658,2011,0.07230710030090444,0.9276928996990955
4428,Wuthering Heights,1742215,100915,1641300,2011,0.057923390626300426,0.9420766093736995
4429,L'odyssée d'Alice Tremblay,1734925,1734925,0,2002,1.0,0.0
4430,First Position,1730824,1014071,716753,2012,0.5858891487522706,0.4141108512477294
4431,Matthias & Maxime,1730255,374739,1355516,2019,0.21658021505500635,0.7834197849449936
4432,After Love,1728251,13693,1714558,2016,0.007923038956725614,0.9920769610432744
4433,Elling,1727470,314729,1412741,2001,0.18219071821797195,0.817809281782028
4434,Girl Rising,1727259,1727259,0,2013,1.0,0.0
4435,Diana Vreeland: The Eye Has to Travel,1721472,1017579,703893,2012,0.5911098176444345,0.40889018235556546
4436,A Faithful Man,1720605,77491,1643114,2018,0.04503706545081527,0.9549629345491847
4437,The Souvenir,1719157,1036737,682420,2019,0.6030496342102554,0.39695036578974463
4438,Weiner,1715955,1676108,39847,2016,0.9767785285744672,0.02322147142553272
4439,Safe Conduct,1713421,25440,1687981,2002,0.014847489321071704,0.9851525106789283
4440,The Life and Times of Hank Greenberg,1712385,1712385,0,2000,1.0,0.0
4441,"To Joey, with Love",1709073,1709073,0,2016,1.0,0.0
4442,Paradise: Love,1709036,24267,1684769,2012,0.01419923278386178,0.9858007672161382
4443,The Girl on the Bridge,1708839,1708839,0,2000,1.0,0.0
4444,"Men, Women & Children",1705908,705908,1000000,2014,0.4138019166332534,0.5861980833667466
4445,The Oscar Nominated Short Films 2012: Live Action,1702415,1702415,0,2012,1.0,0.0
4446,Meet the Patels,1700681,1700681,0,2015,1.0,0.0
4447,Rear Window 2000 Re-release,1699210,1574607,124603,2000,0.9266700407836583,0.07332995921634171
4448,Tekken,1697207,0,1697207,2010,0.0,1.0
4449,Dunkirk 2017 Re-release,1696804,1695119,1685,2017,0.9990069566078345,0.0009930433921655065
4450,The Wild Pear Tree,1696258,34014,1662244,2018,0.020052374108184015,0.9799476258918159
4451,Open Hearts,1692272,136170,1556102,2002,0.08046578800571066,0.9195342119942893
4452,State Property: Blood on the Streets,1691706,1691706,0,2005,1.0,0.0
4453,El vacilón: The Movie,1690929,1291951,398978,2005,0.7640480469611675,0.2359519530388325
4454,The Legend of Johnny Lingo,1690767,1690767,0,2003,1.0,0.0
4455,All Good Things 2010 Re-release,1689646,582024,1107622,2010,0.34446505362661767,0.6555349463733824
4456,Slamma Jamma,1687000,1687000,0,2017,1.0,0.0
4457,Tim's Vermeer,1686917,1671377,15540,2014,0.9907879285110056,0.00921207148899442
4458,Janis: Little Girl Blue,1683166,410465,1272701,2015,0.2438648356727738,0.7561351643272262
4459,The Bride,1682689,0,1682689,2015,0.0,1.0
4460,Detachment,1681521,72689,1608832,2012,0.04322812501300906,0.9567718749869909
4461,The Hunter,1680778,176669,1504109,2011,0.10511144243915616,0.8948885575608438
4462,"The Book of Mormon Movie, Volume 1: The Journey",1680020,1680020,0,2003,1.0,0.0
4463,In Between,1679952,107977,1571975,2016,0.06427386020552968,0.9357261397944703
4464,Final Portrait,1677835,461972,1215863,2017,0.275338158996564,0.724661841003436
4465,Marci X,1675706,1648818,26888,2003,0.9839542258606223,0.01604577413937767
4466,Nothing Left to Fear,1675381,7886,1667495,2013,0.0047069890371205115,0.9952930109628795
4467,Ginger & Rosa,1674776,1012973,661803,2012,0.6048408861841822,0.39515911381581775
4468,Happy Endings,1673288,1315701,357587,2005,0.7862968000726713,0.2137031999273287
4469,Equity,1672306,1605463,66843,2016,0.9600294443720229,0.039970555627977175
4470,Divine Intervention,1672044,421343,1250701,2002,0.25199277052517755,0.7480072294748225
4471,La femme de mon frère,1671969,539524,1132445,2019,0.32268780102980377,0.6773121989701962
4472,Vanishing on 7th Street,1671196,22729,1648467,2011,0.013600439445762197,0.9863995605542378
4473,L.I.E.,1667192,1138836,528356,2001,0.6830862912010135,0.31691370879898656
4474,Girlfight,1666028,1565852,100176,2000,0.9398713587046557,0.06012864129534438
4475,A Hard Day's Night,1664617,965351,699266,2000,0.579923790277283,0.420076209722717
4476,The Double,1662515,200406,1462109,2014,0.12054387479210714,0.8794561252078928
4477,The Comedian,1659002,1659002,0,2016,1.0,0.0
4478,Rustom,1658594,1087419,571175,2016,0.6556269949125585,0.3443730050874415
4479,Dear Frankie,1656829,18025,1638804,2005,0.010879215658344947,0.9891207843416551
4480,Rockstar,1651601,986697,664904,2011,0.5974185048325836,0.40258149516741637
4481,What's Cooking?,1649655,1045899,603756,2000,0.6340107477017922,0.36598925229820783
4482,Two Lives,1649260,22620,1626640,2012,0.013715241987315524,0.9862847580126844
4483,Appleseed,1647770,129135,1518635,2004,0.0783695540032893,0.9216304459967107
4484,Dough,1647429,1148304,499125,2016,0.6970279144048089,0.30297208559519107
4485,The Letters,1647416,1647416,0,2015,1.0,0.0
4486,The Little Hours,1647175,1647175,0,2017,1.0,0.0
4487,Short Term 12,1645164,1013100,632064,2013,0.6158048680860996,0.38419513191390037
4488,Asylum,1644363,375403,1268960,2005,0.2282969149755863,0.7717030850244138
4489,A Family Man,1641235,0,1641235,2017,0.0,1.0
4490,Sorry Angel,1636273,30628,1605645,2018,0.018718147888524713,0.9812818521114753
4491,Student of the Year 2,1635907,778566,857341,2019,0.47592314233021804,0.524076857669782
4492,Since Otar Left,1634307,350391,1283916,2003,0.21439729500026616,0.7856027049997338
4493,Mohenjo Daro,1630231,1264339,365892,2016,0.7755581877660283,0.22444181223397175
4494,Iris,1620708,1310678,310030,2015,0.8087070588903121,0.19129294110968786
4495,All You Need Is Love,1620654,0,1620654,2014,0.0,1.0
4496,I Still See You,1620637,1359,1619278,2018,0.0008385591591454472,0.9991614408408546
4497,Son of Sardaar,1618361,771789,846572,2012,0.4768954516328557,0.5231045483671443
4498,Grand Piano,1618085,22555,1595530,2013,0.013939317155773645,0.9860606828442263
4499,Anjaana Anjaani,1615888,854757,761131,2010,0.5289704484469221,0.47102955155307796
4500,Deerskin,1615875,0,1615875,2019,0.0,1.0
4501,In My Father's Den,1614675,0,1614675,2004,0.0,1.0
4502,The Corporation,1613533,1613533,0,2004,1.0,0.0
4503,Session 9,1612259,378176,1234083,2001,0.23456280907720162,0.7654371909227984
4504,Singin' in the Rain 2012 Re-release,1609789,1608925,864,2012,0.9994632836974287,0.0005367163025713307
4505,Walk With Me,1606705,726726,879979,2017,0.4523082955489651,0.5476917044510349
4506,More Than Honey,1604609,79772,1524837,2012,0.049714291768275014,0.950285708231725
4507,We are the Best!,1604273,180590,1423683,2013,0.11256812275716166,0.8874318772428383
4508,Northfork,1599804,1420578,179226,2003,0.8879700263282252,0.1120299736717748
4509,The Code,1598493,13152,1585341,2002,0.008227749511571212,0.9917722504884288
4510,Crazy Mad Lover,1597269,993031,604238,2011,0.6217055486583662,0.37829445134163375
4511,Great Performances at the Met: Verdi: Aida,1595902,1595902,0,2018,1.0,0.0
4512,Monos,1594195,406473,1187722,2019,0.2549706905366031,0.7450293094633968
4513,Made in India,1594164,790628,803536,2018,0.49595148303436787,0.5040485169656321
4514,Queen of the Desert,1592853,0,1592853,2015,0.0,1.0
4515,It's All Gone Pete Tong,1591879,120620,1471259,2005,0.0757720907179503,0.9242279092820497
4516,Nine Lives,1591523,478830,1112693,2005,0.30086275850239047,0.6991372414976095
4517,I Am,1591034,1591034,0,2011,1.0,0.0
4518,The Crossing,1589212,90896,1498316,2019,0.05719564161357956,0.9428043583864204
4519,Beanpole,1587651,196258,1391393,2019,0.12361532855772459,0.8763846714422754
4520,Dance Academy: The Movie,1586858,0,1586858,2017,0.0,1.0
4521,Lovelace,1585583,356582,1229001,2013,0.22489015081518912,0.7751098491848109
4522,Two 2004 Re-release,1585139,47806,1537333,2004,0.030158869348366295,0.9698411306516337
4523,Make Your Move,1583687,125106,1458581,2012,0.07899667042793178,0.9210033295720682
4524,The Bay,1581252,30668,1550584,2012,0.019394758077776346,0.9806052419222236
4525,Lou!,1581125,287,1580838,2014,0.00018151632540121747,0.9998184836745988
4526,The Stray,1579440,1579440,0,2017,1.0,0.0
4527,Lay the Favorite,1576687,20998,1555689,2012,0.013317798649953985,0.986682201350046
4528,After Midnight,1576003,50469,1525534,2004,0.03202341619908084,0.9679765838009191
4529,Adore,1575749,318982,1256767,2013,0.2024319863125409,0.7975680136874591
4530,Genesis: Paradise Lost,1575000,1575000,0,2017,1.0,0.0
4531,Teri Meri Kahaani,1574703,781196,793507,2012,0.49609100890771146,0.5039089910922885
4532,Human Nature,1574660,705308,869352,2002,0.44791129513672795,0.5520887048632721
4533,9 Songs,1574623,66853,1507770,2004,0.04245651181266881,0.9575434881873311
4534,Teen Spirit,1573601,441366,1132235,2019,0.2804815197753433,0.7195184802246567
4535,Caesar Must Die,1567339,76908,1490431,2012,0.04906915479038038,0.9509308452096196
4536,Hope Springs,1567189,0,1567189,2003,0.0,1.0
4537,Ushpizin,1565016,1400666,164350,2005,0.894985099193874,0.10501490080612594
4538,"Bless Me, Ultima",1561962,1561962,0,2013,1.0,0.0
4539,Persecuted,1558836,1558836,0,2014,1.0,0.0
4540,The Married Woman,1558018,802758,755260,2005,0.5152430844829777,0.48475691551702227
4541,The Kid,1553483,1508593,44890,2019,0.9711036425889437,0.028896357411056315
4542,Out of Control,1553195,36486,1516709,2003,0.023490933205424946,0.976509066794575
4543,Eros,1553020,188392,1364628,2004,0.12130687306023104,0.878693126939769
4544,Still Mine,1552730,1159336,393394,2013,0.7466436534362059,0.2533563465637941
4545,Yardie,1551163,36012,1515151,2018,0.0232161288014219,0.9767838711985781
4546,A Home at the End of the World,1548955,1029872,519083,2004,0.6648818074120939,0.33511819258790604
4547,Tel Aviv on Fire,1548893,506145,1042748,2019,0.3267785444184976,0.6732214555815024
4548,Cold in July,1547630,427418,1120212,2014,0.276175830140279,0.723824169859721
4549,Lagaan: Once Upon a Time in India,1546734,835767,710967,2001,0.5403430712714662,0.4596569287285338
4550,Fed Up,1546229,1538899,7330,2014,0.9952594344046063,0.0047405655953936966
4551,"New York, New York",1545352,92377,1452975,2016,0.059777319342130465,0.9402226806578695
4552,The Lords of Salem,1544989,1165882,379107,2013,0.7546215539398662,0.24537844606013376
4553,Mystery Train,1544973,1541218,3755,2018,0.9975695368139119,0.0024304631860880416
4554,Divided We Fall 2001 Re-release,1544317,1332586,211731,2001,0.8628966721210736,0.1371033278789264
4555,Rampart,1543613,972512,571101,2012,0.6300231988199114,0.3699768011800885
4556,The Wedding Plan,1542345,1412404,129941,2016,0.9157510154991263,0.08424898450087367
4557,The Chaperone,1541223,600654,940569,2019,0.38972556210230447,0.6102744378976955
4558,Kedarnath,1538846,901131,637715,2018,0.5855888113560421,0.4144111886439579
4559,Reaching for the Moon,1534391,45502,1488889,2013,0.029654762052175748,0.9703452379478242
4560,Love,1533874,309200,1224674,2012,0.2015810946661851,0.7984189053338149
4561,The Blind Swordsman: Zatoichi 2004 Re-release,1532969,862894,670075,2004,0.5628907042477702,0.43710929575222984
4562,The Bullet Vanishes,1528580,117629,1410951,2012,0.07695311988904735,0.9230468801109526
4563,Gold,1528185,5539,1522646,2017,0.0036245611624247066,0.9963754388375753
4564,Certain Women,1526698,1087585,439113,2016,0.7123773005532201,0.28762269944677993
4565,Mysterious Skin,1524966,713240,811726,2005,0.4677087882615088,0.5322912117384913
4566,The Sea Is Watching,1523691,30577,1493114,2002,0.02006771714212396,0.979932282857876
4567,Dogtown and Z-Boys,1523090,1300682,222408,2002,0.8539757991976836,0.14602420080231635
4568,The Syrian Bride,1522967,380505,1142462,2005,0.24984454686148813,0.7501554531385118
4569,She Hate Me,1522377,366037,1156340,2004,0.2404378153374624,0.7595621846625376
4570,Shaadi Ke Side Effects,1521778,921277,600501,2014,0.605395136478514,0.39460486352148605
4571,The Kid Stays in the Picture,1521593,1439232,82361,2002,0.9458718592948311,0.05412814070516886
4572,Princess Mononoke 2018 Re-release,1519321,1423877,95444,2018,0.9371798323066686,0.06282016769333143
4573,My Golden Days,1509773,269144,1240629,2015,0.17826785881056292,0.821732141189437
4574,Take a Shot,1508912,564489,944423,2011,0.3741033274306255,0.6258966725693745
4575,The Daughter,1505434,26376,1479058,2016,0.01752052896374069,0.9824794710362593
4576,The Kings of Summer,1501595,1315590,186005,2013,0.8761283834855603,0.12387161651443965
4577,Priceless,1499605,1499605,0,2016,1.0,0.0
4578,The Blind Swordsman: Zatoichi Canadian Release,1496523,255269,1241254,2004,0.17057472554715164,0.8294252744528484
4579,Moka,1493067,129547,1363520,2016,0.0867656977215356,0.9132343022784644
4580,The Artist and the Model,1492780,127958,1364822,2012,0.08571792226583957,0.9142820777341605
4581,In My Country,1491434,163893,1327541,2004,0.10988954254764206,0.890110457452358
4582,Mully,1489771,1489771,0,2017,1.0,0.0
4583,Patti Cake$,1482356,800148,682208,2017,0.5397812671180202,0.4602187328819798
4584,Oasis: Supersonic,1478119,242867,1235252,2016,0.16430815110285438,0.8356918488971457
4585,The Miseducation of Cameron Post,1474577,904703,569874,2018,0.613533915149904,0.386466084850096
4586,Freeheld,1474471,573335,901136,2015,0.3888411504871917,0.6111588495128083
4587,Good Kill,1474471,316472,1157999,2015,0.21463426544163974,0.7853657345583602
4588,Mausam,1473341,728316,745025,2011,0.4943295543937215,0.5056704456062785
4589,De De Pyaar De,1473116,425934,1047182,2019,0.28913812625753843,0.7108618737424616
4590,A Pigeon Sat on a Branch Reflecting on Existence,1472431,222989,1249442,2014,0.15144275011868127,0.8485572498813188
4591,Jimmy P: Psychotherapy Of A Plains Indian,1470582,30283,1440299,2013,0.020592527312315805,0.9794074726876842
4592,Violeta Went to Heaven,1466032,21496,1444536,2011,0.014662708590262696,0.9853372914097374
4593,Modigliani,1466013,205165,1260848,2004,0.13994759937326612,0.8600524006267338
4594,Thelma,1463727,147391,1316336,2017,0.10069568983833733,0.8993043101616627
4595,Joshua,1461635,1461635,0,2002,1.0,0.0
4596,The Center of the World,1460687,1101344,359343,2001,0.7539904168381043,0.24600958316189575
4597,Life of Crime,1456675,265452,1191223,2014,0.1822314517651501,0.8177685482348499
4598,The Other Woman,1451343,25423,1425920,2010,0.017516879193960354,0.9824831208060396
4599,The Disappearance of Eleanor Rigby: Them,1448076,587774,860302,2014,0.4058999665763399,0.5941000334236601
4600,The City of Your Final Destination,1444401,493296,951105,2010,0.34152288734222697,0.658477112657773
4601,Shameless,1443479,679866,763613,2013,0.4709912648538704,0.5290087351461296
4602,The Dawn Wall 2018 Re-release,1442013,970032,471981,2018,0.6726929646265325,0.3273070353734675
4603,No Good Deed,1440653,181600,1259053,2002,0.12605394914667167,0.8739460508533283
4604,Vox Lux,1439539,727119,712420,2018,0.5051054538987829,0.49489454610121714
4605,Tomboy,1437501,129834,1307667,2011,0.09031924151704938,0.9096807584829506
4606,My Friend Dahmer,1436751,1361611,75140,2017,0.947701445831602,0.052298554168398
4607,Restrepo,1436391,1330894,105497,2010,0.9265541207094725,0.07344587929052744
4608,Kai Po Che,1435272,1122527,312745,2013,0.7821005356475985,0.21789946435240148
4609,Monica la mitraille,1435015,1435015,0,2004,1.0,0.0
4610,Timecode,1431406,1057750,373656,2000,0.7389587580323123,0.2610412419676877
4611,The Devil's Hand,1428494,5746,1422748,2014,0.004022418015056416,0.9959775819849436
4612,The Zero Theorem,1428362,257706,1170656,2014,0.18042064966724122,0.8195793503327587
4613,Mere Brother Ki Dulhan,1427275,496172,931103,2011,0.34763587956070136,0.6523641204392987
4614,Fairy Tail: Dragon Cry,1420035,519461,900574,2017,0.3658085892249135,0.6341914107750866
4615,Black Butterflies,1416573,0,1416573,2011,0.0,1.0
4616,It 2019 Re-release,1414696,1347126,67570,2019,0.9522370883921352,0.04776291160786487
4617,The Wolfpack,1414140,1301696,112444,2015,0.9204859490573777,0.07951405094262237
4618,Bombón: El Perro,1412753,19791,1392962,2005,0.01400881824352877,0.9859911817564713
4619,Parkland,1412181,653651,758530,2013,0.4628663039652849,0.5371336960347151
4620,Saint Ralph,1410952,489389,921563,2005,0.34685021177191006,0.65314978822809
4621,Lost in La Mancha,1407019,732393,674626,2002,0.5205281520718625,0.4794718479281374
4622,Lazer Team,1406538,1186426,220112,2016,0.8435079606807637,0.1564920393192363
4623,Just a Sigh,1406331,75531,1330800,2013,0.053707839761763056,0.9462921602382369
4624,El Chicano,1404646,1400603,4043,2019,0.9971216947188117,0.002878305281188285
4625,Haider,1404307,1048143,356164,2014,0.7463773946864894,0.2536226053135105
4626,Universal Soldier: Day of Reckoning,1402307,5460,1396847,2012,0.0038935839299097845,0.9961064160700902
4627,Born to Be Blue 2016 Re-release,1401411,678203,723208,2016,0.4839429689077651,0.5160570310922349
4628,Criminal,1398053,929233,468820,2004,0.664662212376784,0.335337787623216
4629,For Sama,1396596,43796,1352800,2019,0.031359104565672535,0.9686408954343275
4630,Maggie,1394052,187112,1206940,2015,0.1342216789617604,0.8657783210382396
4631,White Material,1392434,304020,1088414,2010,0.21833709892174422,0.7816629010782558
4632,Holiday: A Soldier is Never Off Duty,1390054,706893,683161,2014,0.5085363590191461,0.491463640980854
4633,"Oslo, August 31st",1386378,101475,1284903,2011,0.07319432362602407,0.9268056763739759
4634,"For a Good Time, Call...",1386088,1251749,134339,2012,0.9030804681953816,0.09691953180461847
4635,House of Tolerance,1384443,19327,1365116,2011,0.013960126924691013,0.9860398730753089
4636,Silver City,1384395,1020656,363739,2004,0.7372577913095613,0.2627422086904388
4637,Sometimes Always Never,1377856,0,1377856,2018,0.0,1.0
4638,Swimming with Men,1377748,24708,1353040,2018,0.0179336134039026,0.9820663865960974
4639,Ma ma,1375709,47258,1328451,2015,0.03435174153836313,0.9656482584616368
4640,Khoobsurat,1375623,710508,665115,2014,0.5164990698759762,0.4835009301240238
4641,A Good Old Fashioned Orgy,1369485,200227,1169258,2011,0.14620605556103206,0.8537939444389679
4642,The Salvation,1363964,44903,1319061,2014,0.03292095685809889,0.9670790431419011
4643,Little Italy,1362536,990230,372306,2018,0.726755109589765,0.27324489041023503
4644,Gimme Shelter,1362018,1359910,2108,2014,0.9984522965188419,0.0015477034811581052
4645,Agent Vinod,1361471,698210,663261,2012,0.512835014480661,0.487164985519339
4646,The Bank,1360012,88414,1271598,2001,0.06500972050246616,0.9349902794975339
4647,Chasing Ice,1358668,1328467,30201,2012,0.9777716116078394,0.022228388392160556
4648,Raavan,1356461,708726,647735,2010,0.5224816636821847,0.47751833631781526
4649,Alien 2019 Re-release,1356259,833658,522601,2019,0.6146746307305611,0.38532536926943894
4650,Foxtrot,1356159,618883,737276,2018,0.45634988227781553,0.5436501177221845
4651,Papa,1356033,26677,1329356,2016,0.019672825071366258,0.9803271749286337
4652,Le dernier tunnel,1352489,1352489,0,2004,1.0,0.0
4653,The Oscar Nominated Short Films 2011: Live Action,1352152,1352152,0,2011,1.0,0.0
4654,Unforgivable,1351146,154189,1196957,2011,0.11411720124990193,0.885882798750098
4655,The Teacher,1350426,64437,1285989,2016,0.04771605404516797,0.952283945954832
4656,The Snowtown Murders,1349387,8452,1340935,2011,0.006263584872241989,0.993736415127758
4657,The Cokeville Miracle,1348456,1348456,0,2015,1.0,0.0
4658,The Gathering,1346475,0,1346475,2003,0.0,1.0
4659,Ashoka the Great,1340718,731277,609441,2001,0.5454368480172564,0.45456315198274355
4660,The Rider Named Death,1338136,3375,1334761,2004,0.0025221651610897546,0.9974778348389103
4661,Student of the Year,1337281,670086,667195,2012,0.5010809246523356,0.4989190753476644
4662,Barney Thomson,1336254,0,1336254,2015,0.0,1.0
4663,Godard Mon Amour,1335846,82264,1253582,2017,0.06158194881745351,0.9384180511825465
4664,Darna Mana Hai,1335493,132348,1203145,2003,0.09910048199428975,0.9008995180057102
4665,Mandy,1335484,1214525,120959,2018,0.9094268444998218,0.0905731555001782
4666,Sarah Silverman: Jesus Is Magic,1333799,1324339,9460,2005,0.9929074770636356,0.007092522936364475
4667,Great Performances at the Met: Rossini: Semiramide,1332900,1033651,299249,2018,0.7754902843424113,0.2245097156575887
4668,Ghost in the Shell: The New Movie,1332311,101203,1231108,2015,0.0759604927077837,0.9240395072922163
4669,Kapow,1331922,812737,519185,2016,0.6101986452660141,0.3898013547339859
4670,Ajami,1331651,622403,709248,2010,0.4673919818330779,0.5326080181669222
4671,Ballets Russes,1331363,815848,515515,2005,0.6127915527170276,0.38720844728297243
4672,Baar Baar Dekho,1329777,981947,347830,2016,0.7384298269559483,0.2615701730440517
4673,The Ultimate Life,1327841,1327841,0,2013,1.0,0.0
4674,It's a Wonderful Afterlife,1321438,0,1321438,2010,0.0,1.0
4675,Catfish in Black Bean Sauce,1319592,1319592,0,2000,1.0,0.0
4676,Off the Map,1319492,1317167,2325,2005,0.9982379582445365,0.0017620417554634663
4677,Storytelling,1318945,921445,397500,2001,0.6986227628900371,0.3013772371099629
4678,The Look of Love,1318468,21252,1297216,2013,0.016118707469578327,0.9838812925304217
4679,Noi the Albino,1317132,60555,1256577,2003,0.04597489089931761,0.9540251091006824
4680,Erased,1314735,0,1314735,2012,0.0,1.0
4681,Damsels in Distress,1314358,1008455,305903,2012,0.7672605180628109,0.2327394819371891
4682,Saints and Soldiers,1310470,1310470,0,2004,1.0,0.0
4683,Air Racers,1309987,1309987,0,2012,1.0,0.0
4684,Come What May,1309818,37766,1272052,2015,0.02883301344156211,0.9711669865584379
4685,Dom Hemingway,1307599,523511,784088,2013,0.40036050807625273,0.5996394919237472
4686,Heights,1306281,1160817,145464,2005,0.8886426427391962,0.11135735726080376
4687,Something in the Air,1305473,85154,1220319,2012,0.06522846508506878,0.9347715349149313
4688,Great Performances at the Met: Mozart: Così fan tutte,1302949,1302949,0,2018,1.0,0.0
4689,Les Cowboys,1302493,73725,1228768,2015,0.056602991340452505,0.9433970086595475
4690,Sunset Song,1302482,159714,1142768,2015,0.12262280783918703,0.877377192160813
4691,Jesus' Son,1302067,1302067,0,2000,1.0,0.0
4692,Hard to Be a God,1299035,28608,1270427,2014,0.022022501318286265,0.9779774986817137
4693,Yamakasi,1297401,184441,1112960,2001,0.14216190676591123,0.8578380932340888
4694,Slow West,1295574,229094,1066480,2015,0.17682818580798934,0.8231718141920107
4695,Roger Waters - Us + Them,1294480,611644,682836,2019,0.47250169952413323,0.5274983004758668
4696,Under Suspicion,1291020,260562,1030458,2000,0.20182646279685829,0.7981735372031417
4697,The Business of Strangers,1287598,1030920,256678,2001,0.8006536201516312,0.1993463798483688
4698,The Cakemaker,1287568,875751,411817,2018,0.6801590284940291,0.31984097150597096
4699,Time Changer,1285167,1285167,0,2002,1.0,0.0
4700,Festival Express,1281754,1174079,107675,2004,0.9159940206935184,0.08400597930648158
4701,I Spit on Your Grave,1278650,93051,1185599,2010,0.07277284636139679,0.9272271536386032
4702,Howl,1278390,617334,661056,2010,0.4828995846337972,0.5171004153662028
4703,Black Souls,1278360,101088,1177272,2014,0.07907631653055477,0.9209236834694452
4704,The Villain,1278108,730530,547578,2014,0.5715714165000141,0.4284285834999859
4705,Shed Skin Papa,1278065,13331,1264734,2018,0.0104306119015856,0.9895693880984144
4706,Kontroll,1277800,237183,1040617,2003,0.18561825011738925,0.8143817498826107
4707,City of Ghosts,1277187,357197,919990,2003,0.2796747852898597,0.7203252147101403
4708,The Believer,1274112,416925,857187,2001,0.3272279046112116,0.6727720953887885
4709,Yellow Submarine,1273261,992305,280956,2018,0.7793413919062941,0.22065860809370585
4710,The Women's Balcony,1272517,1200885,71632,2017,0.94370841411156,0.05629158588844
4711,Beautifully Broken,1271572,1209645,61927,2018,0.9512988647123403,0.04870113528765969
4712,Tai ji 1: Cong ling kai shi,1271521,212094,1059427,2012,0.16680337957454106,0.833196620425459
4713,Texas Killing Fields,1271319,45469,1225850,2011,0.03576521706983062,0.9642347829301694
4714,September 11,1266063,127035,1139028,2002,0.10033860874221899,0.899661391257781
4715,Fagara,1265949,43417,1222532,2019,0.03429601034480852,0.9657039896551914
4716,Why Don't You Play in Hell?,1265872,28534,1237338,2013,0.022540983606557378,0.9774590163934426
4717,Batla House,1264337,493180,771157,2019,0.39007005252555293,0.6099299474744471
4718,Valley of Love,1264277,28648,1235629,2015,0.02265959121300158,0.9773404087869985
4719,Black 2005 Re-release,1263200,754819,508381,2005,0.5975451234958835,0.40245487650411654
4720,The Holy Girl,1261792,304124,957668,2004,0.24102546219979204,0.758974537800208
4721,Chonda Pierce: Enough,1260116,1260116,0,2017,1.0,0.0
4722,Meerkats,1259616,777595,482021,2012,0.6173270266493915,0.38267297335060846
4723,The Music of Strangers: Yo-Yo Ma and the Silk Road Ensemble,1259588,1176781,82807,2016,0.9342586623562625,0.06574133764373748
4724,Gett,1259160,988150,271010,2014,0.7847692112201785,0.21523078877982146
4725,Bewafaa,1258036,670076,587960,2005,0.5326365859164602,0.46736341408353976
4726,Guy,1257937,1319,1256618,2018,0.0010485421765954893,0.9989514578234046
4727,Anna,1257142,4288,1252854,2014,0.0034109114165305114,0.9965890885834695
4728,For a Woman,1252416,32286,1220130,2013,0.025778974398283,0.974221025601717
4729,Labyrinth 2018 Re-release,1252236,993336,258900,2018,0.7932498346956963,0.20675016530430365
4730,Demi-soeur,1251642,943,1250699,2013,0.0007534103202033809,0.9992465896797966
4731,The Singles Ward,1250798,1250798,0,2002,1.0,0.0
4732,MVP: Most Valuable Primate,1248746,1248746,0,2000,1.0,0.0
4733,Turn It Up,1247949,1247949,0,2000,1.0,0.0
4734,The Ledge,1247188,9216,1237972,2011,0.007389423246535406,0.9926105767534646
4735,Midnight's Children,1243980,190022,1053958,2012,0.15275325969870898,0.847246740301291
4736,Slumber,1243832,0,1243832,2017,0.0,1.0
4737,1945,1240663,1006193,234470,2017,0.811012337758118,0.18898766224188196
4738,Seducing Doctor Lewis 2004 Re-release,1239278,489838,749440,2004,0.3952607889432395,0.6047392110567604
4739,Bubba Ho-Tep,1239183,1239183,0,2003,1.0,0.0
4740,Nuit de noces,1238180,1238180,0,2001,1.0,0.0
4741,Saving Face,1236518,1187266,49252,2005,0.9601687965723104,0.03983120342768969
4742,Beyond the Mask,1236094,1236094,0,2015,1.0,0.0
4743,The Blue Room,1232900,254666,978234,2014,0.2065585205612783,0.7934414794387217
4744,The Cut,1232140,28066,1204074,2014,0.02277825571769442,0.9772217442823056
4745,Life,1231606,0,1231606,2015,0.0,1.0
4746,True to the Game,1231040,1231040,0,2017,1.0,0.0
4747,Steve McQueen: American Icon,1229782,1229782,0,2017,1.0,0.0
4748,Casablanca 2011 Re-release,1226808,1155330,71478,2011,0.9417366042608134,0.05826339573918657
4749,Rory O'Shea Was Here,1226577,23844,1202733,2004,0.01943946446085325,0.9805605355391468
4750,BTS World Tour 'Love Yourself: Speak Yourself' (The Final) Seoul Live Viewing,1226552,1226552,0,2019,1.0,0.0
4751,That Sugar Film,1226399,3500,1222899,2015,0.0028538836055802394,0.9971461163944197
4752,The Revolution Has Begun,1223419,738525,484894,2013,0.6036566376686973,0.3963433623313027
4753,Santa vs. the Snowman 3D 2005 Re-release,1222538,1222538,0,2005,1.0,0.0
4754,Sister,1218174,154659,1063515,2012,0.12695969541297056,0.8730403045870294
4755,Alexandra's Project,1217812,752148,465664,2003,0.617622424479312,0.3823775755206879
4756,Ilo Ilo,1216181,56773,1159408,2013,0.04668137390733781,0.9533186260926622
4757,When We Leave,1214076,19631,1194445,2010,0.016169498449849926,0.9838305015501501
4758,Woman Thou Art Loosed: On the 7th Day,1213128,1213128,0,2012,1.0,0.0
4759,Clandestine Childhood,1212354,9017,1203337,2012,0.007437596609571132,0.9925624033904289
4760,Uncle Boonmee Who Can Recall His Past Lives,1212206,184292,1027914,2010,0.15203026548292947,0.8479697345170706
4761,Margaret Cho: I'm the One That I Want,1210967,1210967,0,2000,1.0,0.0
4762,Kochadaiiyaan,1210580,817192,393388,2014,0.6750417155413108,0.32495828445868924
4763,Casino Jack,1209709,1042959,166750,2010,0.862156931956363,0.13784306804363694
4764,The Way He Looks,1207841,101451,1106390,2014,0.08399367135243795,0.916006328647562
4765,Noble 2014 Re-release,1207386,347321,860065,2014,0.2876635972257422,0.7123364027742578
4766,Alone in Berlin,1205598,33125,1172473,2016,0.02747599116786856,0.9725240088321314
4767,Inequality for All,1205273,1205273,0,2013,1.0,0.0
4768,Meek's Cutoff,1205257,977772,227485,2011,0.8112560225744385,0.1887439774255615
4769,In the Land of Blood and Honey,1203699,303877,899822,2011,0.25245264804573236,0.7475473519542677
4770,"Beats, Rhymes & Life: The Travels of A Tribe Called Quest",1200326,1200326,0,2011,1.0,0.0
4771,The Affair of the Necklace,1198113,471210,726903,2001,0.39329345395634635,0.6067065460436536
4772,Phantom,1197759,1034589,163170,2013,0.8637705915797752,0.13622940842022477
4773,No Entry,1197530,678000,519530,2005,0.5661653570265464,0.4338346429734537
4774,Spirited Away 2017 Re-release,1196791,1196791,0,2017,1.0,0.0
4775,The Captain,1196669,109226,1087443,2018,0.09127503094005109,0.9087249690599489
4776,Yi Yi,1196218,1136776,59442,2000,0.9503083886047526,0.04969161139524735
4777,Great Performances at the Met: Saint-Saëns: Samson et Dalila,1195758,1195758,0,2018,1.0,0.0
4778,Repentance,1194961,1189612,5349,2014,0.9955237032840403,0.0044762967159597674
4779,The First Grader,1194710,332000,862710,2011,0.27789170593700563,0.7221082940629944
4780,When You're Strange,1194182,246078,948104,2010,0.20606406728622606,0.7939359327137739
4781,Free Men,1192651,53810,1138841,2011,0.04511797667549015,0.9548820233245099
4782,Backstage,1191835,1191835,0,2000,1.0,0.0
4783,Indigo,1190000,1190000,0,2005,1.0,0.0
4784,Time Out,1189692,448542,741150,2001,0.3770236330075347,0.6229763669924653
4785,Kingdom Men Rising,1188936,1188936,0,2019,1.0,0.0
4786,Shubh Mangal Savdhan,1188541,689874,498667,2017,0.5804376963016,0.4195623036984
4787,Kill the Irishman,1188194,1188194,0,2011,1.0,0.0
4788,Dead Snow 2: Red vs. Dead,1187477,37473,1150004,2014,0.03155682173212618,0.9684431782678738
4789,Los Domirriqueños 2,1187280,1187280,0,2019,1.0,0.0
4790,Chuck & Buck,1182065,1055671,126394,2000,0.8930735619445631,0.10692643805543689
4791,Remember 2016 Re-release,1181023,637555,543468,2016,0.5398328398346179,0.46016716016538206
4792,Fire at Sea,1178377,120933,1057444,2016,0.10262674848541681,0.8973732515145832
4793,Any Body Can Dance 2,1176958,892133,284825,2015,0.7579990110097387,0.24200098899026135
4794,Owning Mahowny,1176302,1011871,164431,2003,0.860213618611547,0.13978638138845295
4795,National Theater Live: Cyrano de Bergerac,1173512,86300,1087212,2019,0.0735399382366776,0.9264600617633224
4796,Little Manhattan,1172444,385373,787071,2005,0.3286920313464865,0.6713079686535135
4797,Double Dhamaal,1172240,543646,628594,2011,0.46376680543233467,0.5362331945676653
4798,Raanjhanaa,1171761,903232,268529,2013,0.7708329599636786,0.2291670400363214
4799,Honeyland,1170207,815082,355125,2019,0.6965280501654836,0.3034719498345165
4800,The Innkeepers,1169750,78396,1091354,2012,0.06701944860012823,0.9329805513998718
4801,Dark Tide,1167612,0,1167612,2012,0.0,1.0
4802,Great Performances at the Met: Verdi: Luisa Miller,1166858,1166858,0,2018,1.0,0.0
4803,Her & Him,1166781,857986,308795,2016,0.7353445076668201,0.2646554923331799
4804,You Ain't Seen Nothin' Yet,1166740,18929,1147811,2012,0.01622383735879459,0.9837761626412054
4805,The Emperor's New Clothes,1165545,661903,503642,2001,0.5678914156038591,0.43210858439614086
4806,The Best Two Years,1163450,1163450,0,2004,1.0,0.0
4807,Vaxxed: From Cover-Up to Catastrophe,1163265,1163265,0,2016,1.0,0.0
4808,Groove,1162001,1115313,46688,2000,0.959821032856254,0.040178967143746004
4809,Trois,1161843,1161843,0,2000,1.0,0.0
4810,Louder Than Bombs,1160724,163807,996917,2015,0.14112484966279668,0.8588751503372033
4811,Where Hope Grows,1159072,1156000,3072,2015,0.9973496038209878,0.002650396179012175
4812,Breathe,1158695,42297,1116398,2014,0.03650399803226906,0.9634960019677309
4813,Darling Companion,1157257,793815,363442,2012,0.6859452999636209,0.31405470003637914
4814,Napping Princess,1156847,48198,1108649,2017,0.041663245009927845,0.9583367549900722
4815,Embrace: The Documentary,1155263,629126,526137,2016,0.5445738329713667,0.4554261670286333
4816,Detective Jagga,1154862,861740,293122,2017,0.7461843925940935,0.25381560740590653
4817,Step,1152839,1146292,6547,2017,0.9943209763028489,0.00567902369715112
4818,The Reckoning,1152528,257252,895276,2004,0.2232067246956256,0.7767932753043744
4819,Liberal Arts,1150681,327345,823336,2012,0.28447936482830605,0.715520635171694
4820,Les aimants,1150414,1150414,0,2004,1.0,0.0
4821,The Goonies 2019 Re-release,1148405,864378,284027,2019,0.7526769737157187,0.24732302628428124
4822,Cartel Land,1145923,704352,441571,2015,0.6146591001315097,0.3853408998684903
4823,Elliot the Littlest Reindeer 2018 Re-release,1142187,24262,1117925,2018,0.021241705605124204,0.9787582943948758
4824,Roma,1140769,0,1140769,2018,0.0,1.0
4825,The Song of Names,1138700,1077584,61116,2019,0.946328269078774,0.05367173092122596
4826,The Hollars,1138609,1016985,121624,2016,0.8931819439333433,0.10681805606665677
4827,Fathom Premieres 6 Below: Miracle on the Mountain,1135531,14838,1120693,2017,0.01306701446283721,0.9869329855371628
4828,Cell,1133031,0,1133031,2016,0.0,1.0
4829,Miral,1132843,373420,759423,2010,0.3296308491114832,0.6703691508885168
4830,Dancer,1131649,71917,1059732,2016,0.06355062391253825,0.9364493760874617
4831,Stranger By The Lake,1131241,325196,806045,2013,0.2874683643891974,0.7125316356108027
4832,Weekend,1128477,484592,643885,2011,0.4294212465118917,0.5705787534881083
4833,The Lady and the Duke,1128137,331051,797086,2001,0.29344928851726343,0.7065507114827366
4834,In the Name Of,1127938,9883,1118055,2013,0.008762006422338816,0.9912379935776612
4835,Tosca,1125058,69613,1055445,2001,0.06187503222056107,0.9381249677794389
4836,Man-Thing,1123136,0,1123136,2005,0.0,1.0
4837,Paper Clips,1121744,1121744,0,2004,1.0,0.0
4838,Look Away,1119537,0,1119537,2018,0.0,1.0
4839,Papa Hemingway in Cuba,1117399,1115615,1784,2016,0.9984034351203106,0.00159656487968935
4840,The Mill and the Cross,1116180,312187,803993,2011,0.2796923435288215,0.7203076564711784
4841,Great Performances at the Met: Donizetti: L'Elisir d'Amore,1115018,1115018,0,2018,1.0,0.0
4842,A War,1114663,122902,991761,2015,0.11025933398704361,0.8897406660129564
4843,The Selfish Giant,1114027,12189,1101838,2013,0.01094138651935725,0.9890586134806427
4844,Walking With The Enemy,1112592,1112592,0,2014,1.0,0.0
4845,Jet Lag 2003 Re-release,1112018,544964,567054,2003,0.49006760681931405,0.509932393180686
4846,The R.M.,1111615,1111615,0,2003,1.0,0.0
4847,Sordid Lives,1111273,1111273,0,2001,1.0,0.0
4848,The Overnight,1110522,1110522,0,2015,1.0,0.0
4849,Sacred Planet,1108356,1108356,0,2004,1.0,0.0
4850,Intimate Stories,1108009,102897,1005112,2002,0.09286657418847681,0.9071334258115232
4851,My Neighbor Totoro 2019 Re-release,1105703,1105564,139,2019,0.9998742881225791,0.0001257118774209711
4852,"Peace, Love & Misunderstanding",1105020,590700,514320,2012,0.5345604604441548,0.46543953955584516
4853,American Desi,1104408,907835,196573,2001,0.822010525095798,0.17798947490420208
4854,The Heart Specialist,1103037,1103037,0,2011,1.0,0.0
4855,The Insanity of God,1102525,1102525,0,2016,1.0,0.0
4856,El Coyote,1101470,1101470,0,2019,1.0,0.0
4857,Chaar Sahibzaade 2: Rise of Banda Singh Bahadur 2016 Re-release,1100947,700723,400224,2016,0.6364729637303158,0.3635270362696842
4858,Beyond the Reach,1100432,45895,1054537,2015,0.04170634805240124,0.9582936519475987
4859,Yaadein...,1093819,1000229,93590,2001,0.9144373977778774,0.08556260222212267
4860,Columbus,1093077,1017107,75970,2017,0.9304989492963441,0.06950105070365582
4861,Northern Soul,1092359,8886,1083473,2014,0.008134688321330259,0.9918653116786698
4862,Bombshell: The Hedy Lamarr Story,1092277,820300,271977,2017,0.7509999752809956,0.24900002471900443
4863,The Son of No One,1091132,30680,1060452,2011,0.028117587972857547,0.9718824120271424
4864,Snowboarder,1090565,27732,1062833,2003,0.02542902073695745,0.9745709792630426
4865,The Man Who Cried,1090432,747092,343340,2001,0.6851339652541378,0.31486603474586217
4866,The Sky Is Pink,1088641,652592,436049,2019,0.5994556515876216,0.40054434841237835
4867,Tycoon: A New Russian,1086121,123159,962962,2002,0.1133934432719743,0.8866065567280257
4868,Sunset,1083299,164906,918393,2018,0.15222574746215034,0.8477742525378497
4869,Undiscovered,1082784,1069318,13466,2005,0.9875635399119307,0.012436460088069274
4870,Jesus Is King,1082629,973000,109629,2019,0.8987381642280042,0.10126183577199577
4871,Mystify: Michael Hutchence,1082456,289573,792883,2019,0.2675147996777698,0.7324852003222302
4872,The Statement,1079822,765637,314185,2003,0.7090400084458365,0.2909599915541636
4873,The Cup,1079108,1079108,0,2000,1.0,0.0
4874,Page One: Inside the New York Times,1077982,1067028,10954,2011,0.9898384203075747,0.010161579692425291
4875,Turtles Can Fly,1075553,258578,816975,2005,0.24041400098368002,0.75958599901632
4876,The Salton Sea,1073198,764554,308644,2002,0.7124072165620883,0.2875927834379117
4877,The First Monday in May,1072943,527474,545469,2016,0.4916141864013279,0.5083858135986721
4878,Killing Season,1071322,39881,1031441,2013,0.03722596940975729,0.9627740305902427
4879,When Brendan Met Trudy,1069648,133376,936272,2001,0.12469148729301602,0.875308512706984
4880,Au nom de ma fille,1066493,1623,1064870,2016,0.001521810269734541,0.9984781897302655
4881,The Oogieloves in the Big Balloon Adventure,1065907,1065907,0,2012,1.0,0.0
4882,50 to 1,1064454,1064454,0,2014,1.0,0.0
4883,La Mission,1062941,1062941,0,2010,1.0,0.0
4884,Carlos,1059369,145526,913843,2010,0.1373704535435717,0.8626295464564283
4885,Bennett's War,1056416,1056416,0,2019,1.0,0.0
4886,Borgman,1052010,57474,994536,2013,0.05463256052699119,0.9453674394730088
4887,All Over the Guy,1051948,1022324,29624,2001,0.971838912189576,0.02816108781042409
4888,No One Lives,1048704,74918,973786,2013,0.07143865189796167,0.9285613481020383
4889,Reservation,1048507,651096,397411,2011,0.6209743950207295,0.3790256049792705
4890,Extremedays,1047553,1047553,0,2001,1.0,0.0
4891,A Tale of Two Sisters,1045252,72541,972711,2003,0.06940048906866478,0.9305995109313352
4892,A Brilliant Young Mind,1043620,171793,871827,2015,0.16461259845537649,0.8353874015446235
4893,Made In Mexico,1042673,151133,891540,2012,0.14494764897527795,0.855052351024722
4894,Khatta Meetha,1040814,541904,498910,2010,0.5206540265599809,0.47934597344001906
4895,Spark: A Space Tail,1040689,196458,844231,2017,0.18877685840822764,0.8112231415917723
4896,Befikre,1040421,498000,542421,2016,0.4786523916760619,0.5213476083239381
4897,The Dark Crystal 2018 Re-release,1036956,1036956,0,2018,1.0,0.0
4898,Swept Away,1036520,598645,437875,2002,0.5775527727395515,0.4224472272604484
4899,Noah,1035603,1035603,0,2019,1.0,0.0
4900,Unconditional,1034448,1005800,28648,2012,0.9723060028150279,0.02769399718497208
4901,Margaret Cho: Notorious C.H.O.,1033395,1033395,0,2002,1.0,0.0
4902,Urbania,1032075,1032075,0,2000,1.0,0.0
4903,Ain't Them Bodies Saints,1031243,396519,634724,2013,0.38450588270659775,0.6154941172934022
4904,We Are Family,1031070,638144,392926,2010,0.6189143317136567,0.3810856682863433
4905,The Eyes of Tammy Faye,1029591,1029591,0,2000,1.0,0.0
4906,Breaking News,1028420,0,1028420,2004,0.0,1.0
4907,Knight of Cups,1026288,566006,460282,2015,0.5515079587796018,0.44849204122039815
4908,Casablanca 2017 Re-release,1024560,1024560,0,2017,1.0,0.0
4909,Tangerines,1024132,144501,879631,2015,0.14109606964727203,0.8589039303527279
4910,Great Performances at the Met: Puccini: La Fanciulla del West,1023233,1023233,0,2018,1.0,0.0
4911,"The Bread, My Sweet",1023156,1023156,0,2001,1.0,0.0
4912,Pinjar,1022336,66290,956046,2003,0.06484169588080631,0.9351583041191937
4913,Ma Mère,1022148,71616,950532,2004,0.07006421770624215,0.9299357822937578
4914,The Taste of Others,1021938,891369,130569,2000,0.8722339319997886,0.12776606800021137
4915,Leaves of Grass,1018753,70066,948687,2010,0.06877623918653492,0.9312237608134651
4916,The Oscar Nominated Short Films 2010: Live Action,1018169,1018169,0,2010,1.0,0.0
4917,On a Clear Day,1017257,191033,826224,2005,0.1877922688170246,0.8122077311829754
4918,Husband Material,1016545,567417,449128,2018,0.5581818807824543,0.4418181192175457
4919,Savage Messiah,1015671,1015671,0,2002,1.0,0.0
4920,Two Family House,1015122,1015122,0,2000,1.0,0.0
4921,Assassination Tango,1013272,1013272,0,2003,1.0,0.0
4922,Big Stone Gap,1012804,1009301,3503,2015,0.9965412853819693,0.0034587146180307345
4923,L'attesa,1010766,55804,954962,2015,0.05520961330317799,0.944790386696822
4924,Elvis: The Comeback Special,1010657,1010657,0,2018,1.0,0.0
4925,Far from Men,1010485,5336,1005149,2015,0.0052806325675294535,0.9947193674324706
4926,Cold Blood,1009888,5083,1004805,2019,0.005033231407839285,0.9949667685921607
4927,The Song,1009620,1009620,0,2014,1.0,0.0
4928,Francofonia,1008154,307040,701114,2015,0.3045566451157264,0.6954433548842737
4929,Sidewalls,1008116,2377,1005739,2011,0.0023578635791912834,0.9976421364208087
4930,Lilya 4-Ever,1007747,184023,823724,2002,0.18260833324237136,0.8173916667576286
4931,The Princess and the Warrior,1004858,872091,132767,2001,0.8678748639111198,0.1321251360888802
4932,Ghost House,1004155,0,1004155,2017,0.0,1.0
4933,Faith of Our Fathers,1004105,1004105,0,2015,1.0,0.0
4934,Kiki's Delivery Service 2019 Re-release,1004057,1004057,0,2019,1.0,0.0
4935,Valentin 2003 Re-release,1002172,275968,726204,2003,0.2753698965846182,0.7246301034153818
4936,The Workshop,1000056,22061,977995,2017,0.022059764653179423,0.9779402353468206
4937,Gabbar is Back,998582,534601,463981,2015,0.5353601406794835,0.4646398593205165
4938,Transit,998544,815290,183254,2018,0.8164787931227868,0.1835212068772132
4939,National Theatre Live: Antony & Cleopatra,998079,83672,914407,2018,0.08383304327613346,0.9161669567238665
4940,The Son,997544,70262,927282,2002,0.07043498833134178,0.9295650116686582
4941,"Polina, danser sa vie",996425,165203,831222,2016,0.16579571969792006,0.8342042803020799
4942,Photograph,996171,344534,651637,2019,0.34585829139776203,0.654141708602238
4943,Burn,996103,996103,0,2012,1.0,0.0
4944,Long Live Freedom 2014 Re-release,995990,48541,947449,2014,0.04873643309671784,0.9512635669032822
4945,Duma,994790,870067,124723,2005,0.8746237899456166,0.12537621005438335
4946,Child's Pose,994126,97170,896956,2013,0.09774414913200137,0.9022558508679986
4947,Blue Ruin,993313,258384,734929,2014,0.2601234454799243,0.7398765545200757
4948,All Access: Front Row. Backstage. Live!,992683,992683,0,2001,1.0,0.0
4949,Beyond Skyline,992181,0,992181,2017,0.0,1.0
4950,First Descent,988368,750805,237563,2005,0.7596411458080391,0.2403588541919609
4951,Blackthorn,987883,200558,787325,2011,0.20301796872706585,0.7969820312729341
4952,The Greatest,985181,114766,870415,2010,0.1164922993845801,0.8835077006154199
4953,American Masters: Miles Davis: Birth of the Cool,984499,614201,370298,2019,0.6238716342017615,0.3761283657982385
4954,Being Flynn,983124,540152,442972,2012,0.5494240807873676,0.4505759192126324
4955,Schindler's List 2018 Re-release,981489,833050,148439,2018,0.8487614226955167,0.15123857730448328
4956,Mr. Pip,977855,1714,976141,2013,0.0017528161128183626,0.9982471838871816
4957,Stuck in Love.,977671,81071,896600,2013,0.08292257824973841,0.9170774217502616
4958,Saraband,975181,645634,329547,2004,0.6620658113724529,0.3379341886275471
4959,Who Killed Bambi?,973173,14532,958641,2003,0.014932596773646618,0.9850674032263533
4960,Journey's End,970809,161796,809013,2018,0.166661001288616,0.8333389987113841
4961,An American Rhapsody,970676,850255,120421,2001,0.8759410967202238,0.12405890327977616
4962,Trishna,967672,240381,727291,2012,0.24841165188204267,0.7515883481179573
4963,Ryuichi Sakamoto: Coda,960212,117460,842752,2018,0.12232715275376688,0.8776728472462332
4964,Rush: Cinema Strangiato 2019,960073,960073,0,2019,1.0,0.0
4965,A Prayer Before Dawn,958883,14453,944430,2018,0.015072746101453462,0.9849272538985465
4966,The Endless,956425,272020,684405,2018,0.2844133099824869,0.7155866900175132
4967,The Fighting Preacher,954641,954641,0,2019,1.0,0.0
4968,The Catcher Was a Spy,953953,725223,228730,2018,0.7602292775430236,0.2397707224569764
4969,The Farewell Party,951531,172860,778671,2015,0.1816651270426292,0.8183348729573708
4970,Gimme Danger,950040,440627,509413,2016,0.4637983663845733,0.5362016336154267
4971,Under the Tree,944991,67596,877395,2017,0.07153083997625374,0.9284691600237462
4972,The Dinner,944808,7282,937526,2014,0.0077073860509225154,0.9922926139490775
4973,Rebel in the Rye,944370,378294,566076,2017,0.4005781632199244,0.5994218367800757
4974,Dark Horse 2016 Re-release,944061,940715,3346,2016,0.9964557375000133,0.0035442624999867593
4975,Afterimage,943029,33443,909586,2017,0.03546338447704153,0.9645366155229584
4976,The Road,942041,92476,849565,2011,0.0981655787805414,0.9018344212194586
4977,Landline,940854,940854,0,2017,1.0,0.0
4978,Becoming Astrid,938766,120486,818280,2018,0.12834508280018664,0.8716549171998134
4979,Revenge,938055,102091,835964,2018,0.10883263774512156,0.8911673622548785
4980,Kaili Blues,935236,32164,903072,2016,0.034391319410287884,0.9656086805897122
4981,Barely Lethal,933847,6075,927772,2015,0.006505348306521304,0.9934946516934787
4982,Perfect Sense,933352,2959,930393,2011,0.0031702937369824033,0.9968297062630176
4983,A Borrowed Identity,930958,281540,649418,2015,0.30241965802968557,0.6975803419703145
4984,Simpatico,929606,929606,0,2000,1.0,0.0
4985,Dirty Dancing 2019 Re-release,928944,622968,305976,2019,0.6706195421898413,0.3293804578101586
4986,White Christmas 2018 Re-release,928298,928298,0,2018,1.0,0.0
4987,Like Arrows,928265,817990,110275,2018,0.8812031047168642,0.11879689528313574
4988,Toni Morrison: The Pieces I Am,927495,903018,24477,2019,0.9736095612375268,0.026390438762473115
4989,Aimee & Jaguar,927107,927107,0,2000,1.0,0.0
4990,How I Live Now,925762,60213,865549,2013,0.06504155495688957,0.9349584450431104
4991,Patterns of Evidence: Exodus,925576,925576,0,2015,1.0,0.0
4992,The Uniform,924170,587877,336293,2004,0.6361134856141186,0.3638865143858814
4993,The Yards,924036,889352,34684,2000,0.9624646658788186,0.03753533412118142
4994,Gentleman,923884,897876,26008,2016,0.9718492797797126,0.028150720220287397
4995,ATM,921752,3010,918742,2012,0.003265520443676824,0.9967344795563232
4996,Paradise,921242,14873,906369,2017,0.01614450926032465,0.9838554907396754
4997,Palo Alto,919591,767732,151859,2014,0.8348624551566947,0.16513754484330534
4998,Back to 1942,918487,312954,605533,2012,0.3407277402946367,0.6592722597053633
4999,Kirk Cameron: Connect,918127,918127,0,2018,1.0,0.0
5000,Faithless,918033,739055,178978,2001,0.8050418666867095,0.19495813331329048
5001,Hasee Toh Phasee,916906,646035,270871,2014,0.7045814947224688,0.29541850527753116
5002,The Lodgers,916727,7362,909365,2018,0.00803074415829358,0.9919692558417064
5003,The Ballad of Jack and Rose,916051,712275,203776,2005,0.7775495032481816,0.2224504967518184
5004,Memories of Murder,914793,15357,899436,2003,0.016787404363610127,0.9832125956363899
5005,Kings,910269,274635,635634,2018,0.3017075172284237,0.6982924827715763
5006,Seymour: An Introduction,907742,743541,164201,2015,0.8191104961541936,0.1808895038458064
5007,Sholem Aleichem: Laughing in the Darkness,906666,906666,0,2011,1.0,0.0
5008,The Dead Lands,906158,5240,900918,2014,0.0057826560048026944,0.9942173439951973
5009,Bitter Harvest,904399,557241,347158,2017,0.6161450864054472,0.38385491359455287
5010,Generation Iron,901649,849521,52128,2013,0.9421859282270595,0.05781407177294047
5011,A Song for Martin,900626,27983,872643,2001,0.031070610886205816,0.9689293891137942
5012,The Wildest Dream,898137,898137,0,2010,1.0,0.0
5013,The Game Changers,897992,739711,158281,2019,0.8237389642669423,0.17626103573305776
5014,The Disappearance of Alice Creed,896919,166980,729939,2010,0.1861706575510163,0.8138293424489836
5015,A Woman's Life,895944,37626,858318,2016,0.04199592831694838,0.9580040716830516
5016,Place Vendôme,895788,895788,0,2000,1.0,0.0
5017,The High Note,895200,0,895200,2020,0.0,1.0
5018,You're Not You,894964,11486,883478,2014,0.01283403578244488,0.9871659642175551
5019,Best of Enemies: Buckley vs. Vidal,892802,892802,0,2015,1.0,0.0
5020,Lucky: No Time for Love,891789,453507,438282,2005,0.5085362120411892,0.4914637879588109
5021,Personal Velocity,890502,811299,79203,2002,0.9110580324356374,0.08894196756436257
5022,Believe,890303,890303,0,2016,1.0,0.0
5023,Alone Yet Not Alone,887851,887851,0,2013,1.0,0.0
5024,The Future,887172,568662,318510,2011,0.6409828082942203,0.3590171917057797
5025,La otra conquista,886410,886410,0,2000,1.0,0.0
5026,Code 46,886018,285585,600433,2004,0.3223241514280748,0.6776758485719252
5027,The Nightingale,885916,400209,485707,2019,0.4517459894617548,0.5482540105382452
5028,The Claim,885836,669258,216578,2000,0.7555100492641978,0.24448995073580213
5029,Gaz Bar Blues,884664,884664,0,2003,1.0,0.0
5030,Princess Kaiulani,883887,883887,0,2010,1.0,0.0
5031,Pandora's Box,881950,881950,0,2002,1.0,0.0
5032,Venom,881779,881779,0,2005,1.0,0.0
5033,Ai Weiwei: Never Sorry,881661,534100,347561,2012,0.6057883925908031,0.394211607409197
5034,The Hummingbird Project,876980,371784,505196,2019,0.423936691828776,0.576063308171224
5035,Between Me and My Mind,875191,875191,0,2019,1.0,0.0
5036,The Polar Express 2017 IMAX Release,875150,875150,0,2017,1.0,0.0
5037,Lajja,871706,376000,495706,2001,0.43133808875928353,0.5686619112407165
5038,Particle Fever,869838,869838,0,2014,1.0,0.0
5039,Mirrormask,866999,866999,0,2005,1.0,0.0
5040,The Other Side of the Bed 2003 Re-release,866250,113543,752707,2003,0.1310741702741703,0.8689258297258298
5041,Bird People,866211,32111,834100,2014,0.037070644450370636,0.9629293555496293
5042,Howl's Moving Castle 2019 Re-release,865647,865647,0,2019,1.0,0.0
5043,Great Performances at the Met: Nico Muhly: Marnie,865551,849710,15841,2018,0.981698363239139,0.018301636760861002
5044,The Battle of Algiers 2004 Re-release,865058,822941,42117,2004,0.9513130911453336,0.048686908854666394
5045,Latter Days,865028,834685,30343,2004,0.9649225227391484,0.03507747726085167
5046,Brave,861630,527193,334437,2010,0.6118554367884127,0.38814456321158736
5047,Love,861057,249083,611974,2015,0.2892758551408327,0.7107241448591672
5048,Highway,858783,529136,329647,2014,0.6161463373168775,0.3838536626831225
5049,Night Moves,858513,271755,586758,2014,0.3165415083988245,0.6834584916011756
5050,Himalaya,857100,132007,725093,2000,0.15401586746003967,0.8459841325399603
5051,Steel Magnolias 2019 Re-release,855421,855421,0,2019,1.0,0.0
5052,Chain Letter,855185,138788,716397,2010,0.16229003081204652,0.8377099691879535
5053,A Touch of Sin,854891,154120,700771,2013,0.18028029304320667,0.8197197069567933
5054,Happythankyoumoreplease,853862,216110,637752,2011,0.2530971046843635,0.7469028953156365
5055,I'm Going Home,853526,140872,712654,2002,0.1650471104570921,0.8349528895429079
5056,Brigham City,852206,852206,0,2001,1.0,0.0
5057,The Sea of Trees,850985,20444,830541,2016,0.02402392521607314,0.9759760747839269
5058,31,850419,779820,70599,2016,0.9169832753031153,0.08301672469688472
5059,Wilson,848646,653951,194695,2017,0.7705816088215817,0.22941839117841833
5060,Atlas Shrugged: Who Is John Galt?,846704,846704,0,2014,1.0,0.0
5061,Monty Python's Life of Brian 2004 Re-release,846635,646951,199684,2004,0.7641439345172358,0.2358560654827641
5062,The Polar Express 2015 IMAX Release,846602,846602,0,2015,1.0,0.0
5063,Lizzie,844786,642157,202629,2018,0.7601416216651318,0.23985837833486823
5064,Heartbeats,843423,68723,774700,2010,0.08148105991892561,0.9185189400810744
5065,Higher Ground 2011 Re-release,843370,841733,1637,2011,0.9980589776729075,0.001941022327092498
5066,Gunday,843232,0,843232,2014,0.0,1.0
5067,Mary Kom,839840,621300,218540,2014,0.739783768336826,0.2602162316631739
5068,BANDSTAND: The Broadway Musical on Screen,839554,839554,0,2018,1.0,0.0
5069,Hôtel Normandy,836709,4640,832069,2013,0.005545536142195196,0.9944544638578048
5070,Khiladi 786,835095,379466,455629,2012,0.4543986013567319,0.5456013986432682
5071,The Exception,834572,708973,125599,2017,0.8495048959227005,0.1504951040772995
5072,Premam,834525,828278,6247,2016,0.9925143045445014,0.007485695455498637
5073,Children's Party,832150,6330,825820,2011,0.0076068016583548635,0.9923931983416452
5074,Blow Dry,830286,637769,192517,2001,0.7681317040152429,0.23186829598475706
5075,Gold Diggers,829140,527000,302140,2004,0.6355983308005886,0.3644016691994114
5076,Byzantium,828284,89237,739047,2013,0.10773720124981287,0.8922627987501871
5077,Detective Byomkesh Bakshy!,827437,579055,248382,2015,0.6998176296201403,0.30018237037985973
5078,Mary,827179,0,827179,2005,0.0,1.0
5079,13 Sins,826913,13809,813104,2014,0.01669945931434141,0.9833005406856586
5080,The Shape of Things,826617,735992,90625,2003,0.890366397013369,0.10963360298663105
5081,K: Missing Kings,826323,33531,792792,2014,0.04057856310425826,0.9594214368957418
5082,The Saddest Music in the World,824777,699225,125552,2004,0.8477746105917114,0.15222538940828853
5083,Inside,824414,0,824414,2017,0.0,1.0
5084,The Thing About My Folks,823337,816403,6934,2005,0.9915781751579243,0.008421824842075602
5085,The Lord of the Rings: The Return of the King 2011 Re-release,818580,818580,0,2011,1.0,0.0
5086,Break Ke Baad,816988,427628,389360,2010,0.5234201726341146,0.47657982736588544
5087,Life Itself,815645,810454,5191,2014,0.9936357116147343,0.0063642883852656484
5088,Saw 10th Anniversary Release,815324,815324,0,2014,1.0,0.0
5089,What If...,814906,814906,0,2010,1.0,0.0
5090,Tangerine,814868,702354,112514,2015,0.861923648983639,0.13807635101636093
5091,Charly,814666,814666,0,2002,1.0,0.0
5092,Age of Uprising: The Legend of Michael Kohlhaas,813550,3313,810237,2013,0.004072275828160531,0.9959277241718395
5093,The Heiresses,811196,78473,732723,2018,0.09673740994778081,0.9032625900522192
5094,Bangistan,810419,48694,761725,2015,0.06008496839289306,0.939915031607107
5095,So Close,810243,76584,733659,2002,0.094519792210485,0.905480207789515
5096,Bill W.,809590,809590,0,2012,1.0,0.0
5097,Joni 75: A Birthday Celebration,808831,752205,56626,2019,0.9299903193621412,0.07000968063785884
5098,Breathing,807436,4630,802806,2011,0.005734200605373057,0.9942657993946269
5099,Behind the Sun,805755,19861,785894,2001,0.02464893174724327,0.9753510682527567
5100,V/H/S/2,805574,21833,783741,2013,0.027102413930936202,0.9728975860690638
5101,About Adam,802951,159668,643283,2001,0.19885148657888216,0.8011485134211178
5102,Mean Creek,802948,603951,198997,2004,0.7521670145513781,0.24783298544862184
5103,The Tillman Story,802535,802535,0,2010,1.0,0.0
5104,The Wrecking Crew!,801606,801606,0,2015,1.0,0.0
5105,My Mother Likes Women 2004 Re-release,801048,82916,718132,2004,0.10350940268248594,0.896490597317514
5106,The Whistlers,799694,55608,744086,2019,0.06953659774863885,0.9304634022513611
5107,Chunhyang,798977,798977,0,2000,1.0,0.0
5108,Red Army,798680,694600,104080,2015,0.8696849802173586,0.13031501978264134
5109,Wakefield,798214,262599,535615,2017,0.32898320500517403,0.6710167949948259
5110,Twin Sisters 2004 Re-release,794365,1563,792802,2004,0.001967609348347422,0.9980323906516526
5111,Vita & Virginia,793439,42741,750698,2019,0.05386803522387985,0.9461319647761202
5112,Tickled,790519,613956,176563,2016,0.7766492645970559,0.22335073540294414
5113,Thin Ice,790421,790421,0,2012,1.0,0.0
5114,Lootera,789671,581813,207858,2013,0.7367789877050063,0.26322101229499373
5115,Momentum,789406,0,789406,2015,0.0,1.0
5116,Trembling Before G-d,788896,788896,0,2001,1.0,0.0
5117,Chonda Pierce: Unashamed,787979,787979,0,2019,1.0,0.0
5118,George Takei's Allegiance,784850,784850,0,2017,1.0,0.0
5119,Life During Wartime,783232,281447,501785,2010,0.3593405274554666,0.6406594725445334
5120,Party Monster,782606,742898,39708,2003,0.9492618252351758,0.05073817476482419
5121,The Paris Opera,781039,55482,725557,2017,0.07103614544216102,0.928963854557839
5122,Futuro Beach,779835,20262,759573,2014,0.025982419357941103,0.9740175806420589
5123,Panic,779137,779137,0,2000,1.0,0.0
5124,Foolproof,779036,458990,320046,2003,0.5891768801441782,0.4108231198558218
5125,Mrs. Hyde,778142,18627,759515,2018,0.023937790274782753,0.9760622097252173
5126,Enter the Void,775385,336467,438918,2010,0.43393539983363105,0.566064600166369
5127,The D Train,774780,673151,101629,2015,0.8688285706910349,0.13117142930896514
5128,New Waterford Girl,774469,774469,0,2000,1.0,0.0
5129,Morvern Callar,772336,267907,504429,2002,0.34687881958111494,0.653121180418885
5130,The Church,772000,772000,0,2019,1.0,0.0
5131,The Girl Next Door,771792,771792,0,2000,1.0,0.0
5132,Grand Masti,770535,413903,356632,2013,0.5371631398963058,0.4628368601036942
5133,Pariah,769552,769552,0,2011,1.0,0.0
5134,Passion of Mind,769272,769272,0,2000,1.0,0.0
5135,The Lord of the Rings: The Fellowship of the Ring 2011 Re-release,768580,768580,0,2011,1.0,0.0
5136,Theeb,768449,283024,485425,2015,0.3683055088886836,0.6316944911113165
5137,Yalom's Cure,766974,1164,765810,2014,0.0015176524888718523,0.9984823475111282
5138,Lo and Behold: Reveries of the Connected World,765796,594912,170884,2016,0.7768544103129293,0.2231455896870707
5139,Fat Girl,765705,725854,39851,2001,0.9479551524412143,0.052044847558785697
5140,DanTDM Presents The Contest,765363,307484,457879,2019,0.4017492353301636,0.5982507646698364
5141,Patterns of Evidence: Moses Controversy,765361,765361,0,2019,1.0,0.0
5142,The Polar Express 2016 IMAX Release,765154,765154,0,2016,1.0,0.0
5143,The Lord of the Rings: The Two Towers 2011 Re-release,764607,764607,0,2011,1.0,0.0
5144,Kahlil Gibran's The Prophet,764498,355343,409155,2015,0.4648056633241683,0.5351943366758317
5145,The Invisibles,764250,407373,356877,2018,0.5330363101079489,0.466963689892051
5146,Texas Rangers,763740,623374,140366,2001,0.8162123235656114,0.18378767643438867
5147,Pick of the Litter,763688,578717,184971,2018,0.7577924492724778,0.24220755072752223
5148,Broken Wings,760318,421454,338864,2003,0.5543128006965506,0.44568719930344936
5149,The Shining 2017 Re-release,760309,421572,338737,2017,0.5544745623161109,0.445525437683889
5150,Museo,759626,148505,611121,2018,0.19549752114856522,0.8045024788514348
5151,Bombay Velvet,758478,450692,307786,2015,0.59420576470247,0.40579423529753006
5152,Uzak,757008,96293,660715,2003,0.12720209033458035,0.8727979096654197
5153,Boundaries,755977,703438,52539,2018,0.9305018538923803,0.06949814610761967
5154,I Love Lucy: A Colorized Celebration,754323,754323,0,2019,1.0,0.0
5155,Middle Men,754301,754301,0,2010,1.0,0.0
5156,The Passenger 2005 Re-release,751607,620155,131452,2005,0.825105407480239,0.174894592519761
5157,Tommy's Honour,751345,569306,182039,2017,0.7577158296122287,0.24228417038777125
5158,Little Secrets,750582,405792,344790,2002,0.5406364661023046,0.4593635338976954
5159,A Five Star Life 2014 Re-release,749653,306917,442736,2014,0.4094120879927113,0.5905879120072887
5160,Cronicas,749607,300322,449285,2005,0.40063926830992774,0.5993607316900723
5161,Hobo with a Shotgun,748453,703372,45081,2011,0.9397677609682906,0.060232239031709406
5162,Arthur Newman,747140,207853,539287,2013,0.27819819578659954,0.7218018042134005
5163,The Bride of Humpty Sharma,746788,380011,366777,2014,0.5088606137216988,0.4911393862783012
5164,Holy Rollers,744266,303064,441202,2010,0.40719850161098314,0.5928014983890169
5165,C.S.A.: The Confederate States of America,744165,672156,72009,2005,0.9032351696196408,0.0967648303803592
5166,Saturday's Warrior,744046,744046,0,2016,1.0,0.0
5167,Fade to Black,742076,728921,13155,2004,0.9822727052215676,0.0177272947784324
5168,Scarface 2003 Re-release,739905,739905,0,2003,1.0,0.0
5169,"Kumiko, The Treasure Hunter",739623,623383,116240,2015,0.8428388516852504,0.15716114831474953
5170,Forks Over Knives,739561,739561,0,2011,1.0,0.0
5171,Vicky Donor,739085,549001,190084,2012,0.7428117198968995,0.25718828010310046
5172,Kadosh,736812,736812,0,2000,1.0,0.0
5173,Ramen Shop,734752,88455,646297,2018,0.12038755933975001,0.87961244066025
5174,Wiener-Dog,734729,477453,257276,2016,0.6498355175853955,0.35016448241460457
5175,David Crosby: Remember My Name,732793,732793,0,2019,1.0,0.0
5176,Once I Was a Beehive,732655,732655,0,2015,1.0,0.0
5177,Tabloid,731925,696921,35004,2011,0.9521754278102265,0.04782457218977354
5178,The Polar Express 2018 Re-release,731018,731018,0,2018,1.0,0.0
5179,Slaughterhouse Rulez,730762,4665,726097,2018,0.006383747376026668,0.9936162526239734
5180,How I Ended This Summer,730412,8733,721679,2010,0.011956265778765957,0.988043734221234
5181,Land Ho!,727594,727594,0,2014,1.0,0.0
5182,Peggy Guggenheim: Art Addict,727591,498428,229163,2015,0.6850387099345648,0.3149612900654351
5183,Liz and the Blue Bird,726454,63204,663250,2018,0.08700344412722623,0.9129965558727737
5184,Bullett Raja,725588,0,725588,2013,0.0,1.0
5185,May It Last,725286,725286,0,2017,1.0,0.0
5186,A Tale of Love and Darkness,724885,572212,152673,2015,0.7893831435331121,0.21061685646688785
5187,Levity,723040,209695,513345,2003,0.2900185328612525,0.7099814671387475
5188,The Act of Killing,722714,486919,235795,2013,0.6737367755432992,0.3262632244567007
5189,Where's My Roy Cohn?,722603,705274,17329,2019,0.9760186437089245,0.023981356291075458
5190,Singham,722451,350864,371587,2011,0.4856578508438635,0.5143421491561365
5191,12 Days,722049,5204,716845,2017,0.007207267096831379,0.9927927329031686
5192,Effie Gray,721143,352534,368609,2014,0.4888544990383322,0.5111455009616678
5193,Revive Us 2,718607,718607,0,2017,1.0,0.0
5194,Garage Days,716888,32500,684388,2002,0.045334836125029296,0.9546651638749707
5195,The Shining 2012 Re-release,715736,342749,372987,2012,0.4788762895816335,0.5211237104183666
5196,Passion,713616,92181,621435,2013,0.12917451402434924,0.8708254859756508
5197,Gerhard Richter Painting,713188,242646,470542,2011,0.34022726125509684,0.6597727387449032
5198,Shanghai Ghetto,712446,712446,0,2002,1.0,0.0
5199,Shootout at Wadala,711366,369573,341793,2013,0.5195258137161461,0.48047418628385385
5200,The Polar Express 2011 IMAX Release,711168,711168,0,2011,1.0,0.0
5201,Extraction,710636,16775,693861,2015,0.023605615251690037,0.97639438474831
5202,Inside Deep Throat,709832,691880,17952,2005,0.974709508728826,0.025290491271174026
5203,Kaal,709777,345091,364686,2005,0.4861963687186257,0.5138036312813743
5204,Muscle Shoals,709415,696241,13174,2013,0.9814297695988948,0.018570230401105135
5205,Paris Countdown,708757,1055,707702,2013,0.001488521453756365,0.9985114785462437
5206,Gori Tere Pyaar Mein!,708440,342184,366256,2013,0.48301055841002766,0.5169894415899723
5207,HBO Boxing: Canelo Alvarez vs. Gennady Golovkin II,707875,707875,0,2018,1.0,0.0
5208,Passione,707460,255355,452105,2010,0.3609462019054081,0.639053798094592
5209,Palindromes,707269,553368,153901,2005,0.7824010383602279,0.21759896163977213
5210,Bread and Roses,706876,533479,173397,2001,0.7546995512650027,0.24530044873499737
5211,The Lost Medallion: The Adventures of Billy Stone,705854,549632,156222,2013,0.7786766101771755,0.22132338982282454
5212,Itzhak,704968,607290,97678,2018,0.8614433562941864,0.1385566437058136
5213,Blaze,704955,704955,0,2018,1.0,0.0
5214,Bully,704808,480811,223997,2001,0.6821872055935801,0.3178127944064199
5215,Crossing the Bridge: The Sound of Istanbul,704094,70685,633409,2005,0.1003914250085926,0.8996085749914075
5216,Countdown to Canelo vs. Golovkin,703396,703396,0,2017,1.0,0.0
5217,Buena Vista Social Club: Adios,701575,123445,578130,2017,0.1759541032676478,0.8240458967323522
5218,Le Quattro Volte,701334,152530,548804,2010,0.21748553470956777,0.7825144652904322
5219,56 Up,701278,701278,0,2013,1.0,0.0
5220,Our Children,700215,23203,677012,2012,0.033136965075012674,0.9668630349249874
5221,The Greatest Movie Ever Sold,698249,638476,59773,2011,0.914395867376824,0.08560413262317597
5222,Look What's Happened Now,696718,336909,359809,2004,0.48356580424217543,0.5164341957578246
5223,Himmatwala,696334,270880,425454,2013,0.3890087228255406,0.6109912771744593
5224,Frankie & Alice 2014 Re-release,695876,695876,0,2014,1.0,0.0
5225,Deewane Huye Paagal,695849,364357,331492,2005,0.5236150371704206,0.47638496282957943
5226,Frankie,695680,171781,523899,2019,0.24692531048758048,0.7530746895124195
5227,The Least of These: The Graham Staines Story,695164,607015,88149,2019,0.8731968283743117,0.12680317162568833
5228,The Congress 2013 Re-release,695131,137815,557316,2013,0.19825759461166312,0.8017424053883369
5229,Jim Henson's Holiday Special with Fraggle Rock and Emmet Otter,695130,695130,0,2018,1.0,0.0
5230,The Secret Scripture,694981,0,694981,2017,0.0,1.0
5231,In the Aisles,694586,28394,666192,2018,0.04087902721909166,0.9591209727809084
5232,Raise Hell: The Life & Times of Molly Ivins,694410,694410,0,2019,1.0,0.0
5233,Chris Brown: Welcome To My Life,693984,693984,0,2017,1.0,0.0
5234,Titanic 2017 Re-release,693303,691642,1661,2017,0.9976042221077941,0.002395777892205861
5235,Close Your Eyes,691495,41392,650103,2004,0.059858711921272026,0.940141288078728
5236,Ferrari Ki Sawaari,689861,434107,255754,2012,0.6292673451608367,0.37073265483916323
5237,"The Prize Winner of Defiance, Ohio",689028,627844,61184,2005,0.9112024475057617,0.08879755249423826
5238,Romeo Akbar Walter,688719,236299,452420,2019,0.34309929013138885,0.6569007098686112
5239,Happy Accidents,688523,688523,0,2001,1.0,0.0
5240,Cobain: Montage of Heck,687649,0,687649,2015,0.0,1.0
5241,Vettai,687636,204373,483263,2012,0.29721102443734765,0.7027889755626523
5242,The Caveman's Valentine,687194,687194,0,2001,1.0,0.0
5243,Mr. Church,685780,685780,0,2016,1.0,0.0
5244,Spun,685608,411119,274489,2003,0.5996414860970117,0.4003585139029883
5245,Bethany Hamilton: Unstoppable,684078,590671,93407,2019,0.8634556293288193,0.13654437067118078
5246,Stefan Zweig: Farewell to Europe 2017 Re-release,683063,78372,604691,2017,0.11473612243672984,0.8852638775632702
5247,Masti,683021,308566,374455,2004,0.45176649034217103,0.548233509657829
5248,Brigsby Bear,681632,532669,148963,2017,0.7814612576874325,0.21853874231256748
5249,"Right Now, Wrong Then",680728,24470,656258,2015,0.035946809885886874,0.9640531901141132
5250,3 Generations,680351,155936,524415,2016,0.2291993397525689,0.7708006602474311
5251,A Matter of Faith,680113,680113,0,2014,1.0,0.0
5252,I Spit on Your Grave 2,678604,809,677795,2013,0.0011921533029572474,0.9988078466970427
5253,All I See Is You,678150,217644,460506,2017,0.32093784560937844,0.6790621543906216
5254,Baaghi,676602,438207,238395,2016,0.6476584461766297,0.3523415538233703
5255,Tyrannosaur,676111,22321,653790,2011,0.03301380986258173,0.9669861901374183
5256,Manderlay,674918,78378,596540,2005,0.11612966315908006,0.88387033684092
5257,5 to 7,674579,162685,511894,2015,0.24116523046225868,0.7588347695377413
5258,Beyond the Hills,673493,124919,548574,2012,0.18547928486264892,0.8145207151373511
5259,The Trump Prophecy,671198,671198,0,2018,1.0,0.0
5260,Anna and the Apocalypse,670430,545597,124833,2018,0.8138015900243127,0.18619840997568723
5261,The Polar Express 2012 IMAX Release,669289,669289,0,2012,1.0,0.0
5262,Bright Days Ahead 2013 Re-release,669085,21770,647315,2013,0.03253697213358542,0.9674630278664146
5263,The Torn Poster Let Out a Hero,669070,410526,258544,2013,0.6135770547177425,0.38642294528225746
5264,Travelers and Magicians,668639,506793,161846,2004,0.7579471134648144,0.24205288653518564
5265,Tai Chi 2: The Hero Rises,668484,35067,633417,2012,0.05245750085267561,0.9475424991473244
5266,Girlfriend Boyfriend,667626,64414,603212,2012,0.09648216216863933,0.9035178378313606
5267,Alias Betty,667087,208400,458687,2001,0.31240302988965457,0.6875969701103454
5268,Balzac and the Little Chinese Seamstress 2005 Re-release,666327,666327,0,2005,1.0,0.0
5269,A Bottle in the Gaza Sea,666011,5872,660139,2012,0.008816671196121385,0.9911833288038786
5270,Mr. Gaga: A True Story of Love and Dance,665617,173994,491623,2016,0.2614025783596272,0.7385974216403728
5271,Stockholm,665527,292590,372937,2019,0.43963655869709267,0.5603634413029073
5272,The Stanford Prison Experiment,663114,660561,2553,2015,0.9961499832607967,0.0038500167392032138
5273,Yes,661946,396760,265186,2005,0.5993842398020383,0.40061576019796175
5274,Max,660763,539879,120884,2002,0.8170539209973924,0.1829460790026076
5275,City of Gold,660445,640979,19466,2016,0.9705259332722634,0.0294740667277366
5276,Camille Claudel 1915,660355,35296,625059,2013,0.05345003823700888,0.9465499617629911
5277,Another Happy Day,659937,8464,651473,2011,0.012825466673333969,0.987174533326666
5278,La femme du Vème,659769,113800,545969,2011,0.1724846120384559,0.8275153879615441
5279,Dragon Ball Z: Broly - The Legendary Super Saiyan,658982,658982,0,2018,1.0,0.0
5280,Madame Bovary,658532,44235,614297,2015,0.06717213438375053,0.9328278656162495
5281,Terri,655802,655802,0,2011,1.0,0.0
5282,Dekalog,655720,655720,0,2000,1.0,0.0
5283,The Patience Stone,654587,148671,505916,2013,0.22712183407247624,0.7728781659275238
5284,No Problem,654369,285468,368901,2010,0.4362492721996305,0.5637507278003695
5285,Whisky Galore,653866,20991,632875,2017,0.032102907935265025,0.967897092064735
5286,Ponyo 2018 Re-release,653072,653072,0,2018,1.0,0.0
5287,Rascals,652756,273829,378927,2011,0.4194967185288224,0.5805032814711776
5288,In Secret,652228,444179,208049,2013,0.6810179875748972,0.3189820124251029
5289,Salinger,650675,583633,67042,2013,0.8969654589464786,0.10303454105352135
5290,Metropolis 2002 Re-release,650422,650422,0,2002,1.0,0.0
5291,The Extra Man,649626,453377,196249,2010,0.6979046405162355,0.3020953594837645
5292,The Family Fang,649555,262921,386634,2016,0.4047709585793351,0.5952290414206649
5293,Jodorowsky's Dune,647280,647280,0,2014,1.0,0.0
5294,American Masters: The Life and Times of Allen Ginsberg 2004 Re-release,646951,646951,0,2004,1.0,0.0
5295,Storage 24,646175,72,646103,2012,0.00011142492358881108,0.9998885750764112
5296,Miss Minoes 2004 Re-release,645970,256770,389200,2004,0.3974952397170147,0.6025047602829853
5297,Focus,645418,645418,0,2001,1.0,0.0
5298,The Public,644740,573503,71237,2019,0.889510500356733,0.11048949964326706
5299,Dracula 3D,643758,8139,635619,2012,0.012642949679848638,0.9873570503201513
5300,The Inheritance 2003 Re-release,642318,68215,574103,2003,0.10620128970385385,0.8937987102961461
5301,Love and Honor,641929,19684,622245,2012,0.030663827308004467,0.9693361726919956
5302,Dust to Glory,640013,640013,0,2005,1.0,0.0
5303,Museum Hours,639121,561457,77664,2012,0.87848310413834,0.12151689586166
5304,Aquarela,638907,307346,331561,2019,0.48104966763550877,0.5189503323644913
5305,Beautiful Boxer,638317,133920,504397,2003,0.20980171294200217,0.7901982870579979
5306,Jack Goes Boating,637479,541992,95487,2010,0.8502115363800219,0.14978846361997808
5307,Welcome to Me,636819,608852,27967,2015,0.9560832826910001,0.04391671730899989
5308,The Virginity Hit,636706,636706,0,2010,1.0,0.0
5309,Not Fade Away,636399,610792,25607,2012,0.9597626646176377,0.04023733538236232
5310,Elsa & Fred,635901,285863,350038,2014,0.4495401013679802,0.5504598986320197
5311,Batti Gul Meter Chalu,635869,249539,386330,2018,0.39243775054295776,0.6075622494570423
5312,Goya in Bordeaux,635361,635361,0,2000,1.0,0.0
5313,The Last Lions,635325,635325,0,2011,1.0,0.0
5314,Kaboom,635162,118919,516243,2010,0.18722625094070489,0.8127737490592951
5315,A Beautiful Life,634784,66171,568613,2011,0.10424175782628421,0.8957582421737158
5316,Dinner Rush,634566,634566,0,2001,1.0,0.0
5317,No One Killed Jessica,634297,440525,193772,2011,0.6945090391409703,0.30549096085902977
5318,The Black Prince,632823,0,632823,2017,0.0,1.0
5319,Grace Jones: Bloodlight and Bami,632394,375208,257186,2017,0.5933136620524546,0.4066863379475454
5320,Jonah: The Musical,631154,631154,0,2017,1.0,0.0
5321,Shut Up and Play the Hits,629107,510334,118773,2012,0.8112038174746108,0.18879618252538916
5322,Short Peace,628807,22862,605945,2013,0.03635773774783042,0.9636422622521695
5323,The Trumpet of the Swan,628387,102202,526185,2001,0.1626418114951455,0.8373581885048544
5324,Asako I & II,627102,25559,601543,2019,0.04075732496467879,0.9592426750353212
5325,Korkoro,627088,8242,618846,2010,0.013143290893782054,0.9868567091062179
5326,I'm Still Here,626396,408983,217413,2010,0.652914450283846,0.347085549716154
5327,"Love, Gilda",626318,626318,0,2018,1.0,0.0
5328,Sleepless Night,624913,3358,621555,2011,0.005373547997881305,0.9946264520021187
5329,Our Lady of the Assassins,624525,525330,99195,2001,0.8411672871382251,0.15883271286177494
5330,Give Me Liberty,624445,242734,381711,2019,0.38871958298969483,0.6112804170103051
5331,The Sound of Music 2018 Re-release,624392,616171,8221,2018,0.9868335917180233,0.013166408281976707
5332,Winter in Wartime 2010 Re-release,623392,543100,80292,2010,0.8712014270314665,0.12879857296853345
5333,Nancy Drew and the Hidden Staircase,623088,623088,0,2019,1.0,0.0
5334,Range 15,621738,621738,0,2016,1.0,0.0
5335,The Grey Zone,621592,517872,103720,2001,0.8331381356259411,0.16686186437405887
5336,LOC: Kargil,621103,621103,0,2003,1.0,0.0
5337,Die Hard 30th Anniversary Release,620525,510241,110284,2018,0.822273075218565,0.17772692478143506
5338,Better Than Sex,620388,19521,600867,2000,0.031465792375094295,0.9685342076249057
5339,"Happy, Happy",620238,45154,575084,2010,0.0728010860347157,0.9271989139652843
5340,The Transformers,619597,619597,0,2018,1.0,0.0
5341,Nowitzki: The Perfect Shot,619517,41340,578177,2014,0.06672940371289246,0.9332705962871075
5342,Paradise: Faith,618696,6508,612188,2013,0.010518897810879656,0.9894811021891203
5343,Paulo Coelho's Best Story,617377,8808,608569,2014,0.014266809421147856,0.9857331905788521
5344,The Butterfly 2003 Re-release,616355,38438,577917,2003,0.06236341069675755,0.9376365893032425
5345,The Bronze,615816,615816,0,2016,1.0,0.0
5346,Lost River,615500,45431,570069,2015,0.07381153533712428,0.9261884646628757
5347,Omar,614444,356000,258444,2013,0.5793855908756534,0.42061440912434656
5348,Killerman,614366,291477,322889,2019,0.47443543425254653,0.5255645657474535
5349,Going Upriver: The Long War of John Kerry,614138,614138,0,2004,1.0,0.0
5350,Walking the Camino: Six Ways to Santiago,612717,612717,0,2013,1.0,0.0
5351,The Returned,612521,0,612521,2013,0.0,1.0
5352,The Filth and the Fury,612192,612192,0,2000,1.0,0.0
5353,In Another Country,611365,25079,586286,2012,0.04102132114203463,0.9589786788579654
5354,The Muppet Movie 2019 Re-release,610475,610475,0,2019,1.0,0.0
5355,Project Nim,609880,411184,198696,2011,0.6742047615924445,0.3257952384075556
5356,Friday Night,609542,156918,452624,2002,0.25743591089703416,0.7425640891029658
5357,Dead Before Dawn 3D,608881,0,608881,2012,0.0,1.0
5358,The Last Suit,608209,73548,534661,2017,0.12092553710977641,0.8790744628902236
5359,Gunner Palace,607844,607844,0,2005,1.0,0.0
5360,Mr. Right,607595,34694,572901,2016,0.057100535718694195,0.9428994642813058
5361,Dear Wendy,607229,23106,584123,2005,0.038051542334111184,0.9619484576658888
5362,The Reports on Sarah and Saleem,607206,117479,489727,2018,0.1934747021603871,0.8065252978396129
5363,Life in a Day,607169,252788,354381,2011,0.4163387788243471,0.5836612211756529
5364,Bolshoi Ballet: The Sleeping Beauty,606872,311368,295504,2019,0.513070301480378,0.4869296985196219
5365,The Walking Dead: Wrath/The Walking Dead/Fear the Walking Dead: What's Your Story?/Fear the Walking Dead,605764,605764,0,2018,1.0,0.0
5366,Summer in February,605403,1624,603779,2013,0.0026825106581896685,0.9973174893418103
5367,Blue Collar Comedy Tour: The Movie,604856,604856,0,2003,1.0,0.0
5368,The Golden Glove,604479,6160,598319,2019,0.010190593883327626,0.9898094061166723
5369,The Holy Land,603520,603520,0,2003,1.0,0.0
5370,"DCI 2019: Big, Loud & Live 16",603320,603320,0,2018,1.0,0.0
5371,Undertow,602059,108620,493439,2010,0.1804142118961763,0.8195857881038238
5372,A Talking Picture,601815,20237,581578,2003,0.033626612829524026,0.9663733871704759
5373,The Little Death,601162,18238,582924,2014,0.03033791224328883,0.9696620877567111
5374,Oh Lucy!,600145,375391,224754,2018,0.6255005040448558,0.37449949595514415
5375,Jimi: All Is by My Side,599840,340911,258929,2014,0.568336556415044,0.431663443584956
5376,The Fencer 2016 Re-release,599537,95952,503585,2016,0.1600435002343475,0.8399564997656525
5377,The Fluffer,599523,563373,36150,2001,0.9397020631401964,0.060297936859803544
5378,The One I Love,596933,513447,83486,2014,0.8601417579527351,0.13985824204726494
5379,Fiza,596591,596591,0,2000,1.0,0.0
5380,Trust,595802,120016,475786,2011,0.20143604754599684,0.7985639524540031
5381,Skin Trade,595268,1242,594026,2015,0.002086455176491933,0.997913544823508
5382,Blue Like Jazz,595018,595018,0,2012,1.0,0.0
5383,My First Mister,595005,568762,26243,2001,0.955894488281611,0.04410551171838892
5384,Ixcanul,594836,295157,299679,2015,0.4961989523162687,0.5038010476837314
5385,Are You Here,594396,0,594396,2014,0.0,1.0
5386,The Armstrong Lie,594394,383294,211100,2013,0.644848366571668,0.35515163342833206
5387,Boss,594283,0,594283,2013,0.0,1.0
5388,The Big Lebowski 2018 Re-release,592832,582585,10247,2018,0.9827151705710893,0.01728482942891072
5389,Not One Less,592586,592586,0,2000,1.0,0.0
5390,To Kill a Mockingbird 2019 Re-release,592237,592237,0,2019,1.0,0.0
5391,Compliance,592116,319285,272831,2012,0.5392271109039445,0.4607728890960555
5392,Tarnation,592014,592014,0,2004,1.0,0.0
5393,The Cure: Anniversary 1978-2018 Live in Hyde Park,591904,378405,213499,2019,0.6393013056171271,0.3606986943828729
5394,The Wonderland,591857,50876,540981,2019,0.08595995316436233,0.9140400468356377
5395,The Human Resources Manager,590567,64014,526553,2010,0.10839413648239743,0.8916058635176026
5396,Refugee,590000,590000,0,2000,1.0,0.0
5397,Storm Surfers 3D,589945,117090,472855,2012,0.19847612913068166,0.8015238708693183
5398,Starry Starry Night,589299,10033,579266,2011,0.01702531312627376,0.9829746868737262
5399,Neither Wolf Nor Dog,589289,589289,0,2017,1.0,0.0
5400,Phir Bhi Dil Hai Hindustani,588606,588606,0,2000,1.0,0.0
5401,Elvis on Tour,587818,587818,0,2010,1.0,0.0
5402,A Time for Drunken Horses,587654,587654,0,2000,1.0,0.0
5403,Thunderstruck,587211,587211,0,2012,1.0,0.0
5404,Upstream Color,587174,444098,143076,2013,0.7563311727017885,0.24366882729821143
5405,Seberg,585845,434702,151143,2019,0.7420085517500363,0.25799144824996373
5406,The Piano Player,585604,585604,0,2003,1.0,0.0
5407,The Black Panthers: Vanguard of the Revolution,584109,516893,67216,2015,0.8849255875187679,0.1150744124812321
5408,The Opportunists,584054,584054,0,2000,1.0,0.0
5409,Undefeated,583844,562218,21626,2012,0.9629592836442611,0.03704071635573886
5410,Gleason,583664,583664,0,2016,1.0,0.0
5411,The Flat,583443,471842,111601,2012,0.8087199606473983,0.1912800393526017
5412,Forgive Me Father,582787,582787,0,2001,1.0,0.0
5413,White God,581904,282358,299546,2014,0.48523124089196845,0.5147687591080315
5414,Three Times,581875,151922,429953,2005,0.261090440386681,0.7389095596133191
5415,Touch of Pink,581055,564535,16520,2004,0.9715689564671158,0.02843104353288415
5416,Novitiate,580346,580346,0,2017,1.0,0.0
5417,All the Real Girls,579986,549666,30320,2003,0.9477228760694224,0.05227712393057764
5418,Bedeviled,579942,0,579942,2017,0.0,1.0
5419,Around the Bend,579350,193637,385713,2004,0.3342314662984379,0.6657685337015621
5420,Harry & Snowman,578820,561460,17360,2016,0.9700079472029302,0.0299920527970699
5421,Tibet: Cry of the Snow Lion,578241,578241,0,2003,1.0,0.0
5422,The Painted Bird,577566,0,577566,2019,0.0,1.0
5423,Bilal: A New Breed of Hero 2018 Re-release,576805,490973,85832,2018,0.8511940777212402,0.14880592227875972
5424,Blizzard,576320,504600,71720,2003,0.8755552470849528,0.1244447529150472
5425,Light of My Life,573790,20056,553734,2019,0.03495355443629202,0.965046445563708
5426,Mesrine Part 1: Killer Instinct 2010 Re-release,572790,551697,21093,2010,0.9631749855968156,0.03682501440318441
5427,The Twilight Samurai 2004 Re-release,572565,559765,12800,2004,0.9776444595810083,0.02235554041899173
5428,The Room 2017 Re-release,572340,549602,22738,2017,0.9602718663731349,0.03972813362686515
5429,The Falling,569498,0,569498,2015,0.0,1.0
5430,Youth,567746,331166,236580,2004,0.5832995741053217,0.41670042589467826
5431,The Passion of the Christ Recut Release,567692,508326,59366,2005,0.895425688577609,0.10457431142239101
5432,Goodbye to Language,566423,401889,164534,2014,0.7095209763727814,0.2904790236272185
5433,Margaret,564864,46495,518369,2011,0.08231184851574892,0.9176881514842511
5434,The Weather Underground,564632,564632,0,2003,1.0,0.0
5435,The Cat Returns 2018 Re-release,563718,563718,0,2018,1.0,0.0
5436,Poolhall Junkies,563711,563711,0,2003,1.0,0.0
5437,Like Someone in Love,562878,239056,323822,2012,0.4247030439988772,0.5752969560011229
5438,Beetlejuice 2018 Re-release,562613,512947,49666,2018,0.911722622833102,0.08827737716689803
5439,The Happiest Day in the Life of Olli Maki,562537,0,562537,2016,0.0,1.0
5440,Kurosawa & Mifune Festival,561692,561692,0,2002,1.0,0.0
5441,Kitchen Stories 2004 Re-release,561380,351235,210145,2004,0.6256635434108804,0.3743364565891197
5442,Me You Them,560943,323923,237020,2001,0.577461524611235,0.422538475388765
5443,My Fair Lady 2019 Re-release,560711,560711,0,2019,1.0,0.0
5444,Fiddler: A Miracle of Miracles,558816,549386,9430,2019,0.9831250357899559,0.016874964210044092
5445,The Dance of Reality,558636,293680,264956,2013,0.5257090484680543,0.47429095153194567
5446,Forrest Gump 2014 IMAX Release,558493,557683,810,2014,0.9985496684828638,0.0014503315171362937
5447,Kusama: Infinity,558052,360931,197121,2018,0.6467694766795926,0.35323052332040744
5448,Castle in the Sky 2018 Re-release,557541,523664,33877,2018,0.9392385492726095,0.060761450727390455
5449,Rojo,557092,94757,462335,2018,0.1700921930309536,0.8299078069690464
5450,Tony Takitani,556268,129783,426485,2005,0.23331020299567834,0.7666897970043216
5451,Samaritan's Purse presents Facing Darkness,555533,555533,0,2017,1.0,0.0
5452,Circumstance,555511,454121,101390,2011,0.8174833621656457,0.18251663783435432
5453,Dolores,555309,555309,0,2017,1.0,0.0
5454,Every Thing Will Be Fine,554953,9233,545720,2015,0.01663744497281752,0.9833625550271825
5455,Endless Poetry,554706,153440,401266,2016,0.2766149996574762,0.7233850003425238
5456,Viral,551760,0,551760,2016,0.0,1.0
5457,Open Windows,550108,1750,548358,2014,0.0031811935110923673,0.9968188064889076
5458,Dhadak,549628,0,549628,2018,0.0,1.0
5459,23 Blast,549185,549185,0,2014,1.0,0.0
5460,We Are X,548126,45270,502856,2016,0.0825904992647676,0.9174095007352324
5461,Planetarium,546584,3262,543322,2016,0.005967975645097551,0.9940320243549025
5462,A Girl Walks Home Alone at Night,546352,491910,54442,2014,0.9003536181802209,0.0996463818197792
5463,My Generation,546183,0,546183,2018,0.0,1.0
5464,Rudderless,546149,58293,487856,2014,0.10673460905357329,0.8932653909464268
5465,Masked and Anonymous,546106,533569,12537,2003,0.9770429184077817,0.022957081592218362
5466,"DCI 2019: Big, Loud & Live 16",546060,546060,0,2019,1.0,0.0
5467,Cet amour-là,545905,72844,473061,2002,0.13343713649810865,0.8665628635018914
5468,Primer,545436,424760,120676,2004,0.778753144273572,0.22124685572642802
5469,Dog Days,545059,13031,532028,2002,0.02390750359135433,0.9760924964086457
5470,The Art of the Steal,544890,544890,0,2010,1.0,0.0
5471,He's Out There,544674,0,544674,2018,0.0,1.0
5472,Once Upon a Time in the Midlands,544512,172564,371948,2002,0.3169149623883404,0.6830850376116596
5473,The Day Shall Come,543993,26972,517021,2019,0.04958152035044568,0.9504184796495543
5474,Love & Sex,543896,543896,0,2000,1.0,0.0
5475,On Any Sunday: The Next Chapter,543044,543044,0,2014,1.0,0.0
5476,The Club,541515,52761,488754,2015,0.09743220409406941,0.9025677959059306
5477,Saathiya,541367,317564,223803,2002,0.5865965232457834,0.4134034767542166
5478,Passionada,540833,540833,0,2003,1.0,0.0
5479,Dragon Ball Z: Bardock - The Father of Goku/Dragon Ball Z: Fusion Reborn,540707,540707,0,2018,1.0,0.0
5480,On the Way to School 2015 Re-release,540658,7424,533234,2015,0.013731416163267722,0.9862685838367323
5481,Lawless Heart,539596,330067,209529,2003,0.6116928220372279,0.38830717796277214
5482,The Last Shot,538526,464275,74251,2004,0.8621217917055073,0.13787820829449274
5483,Lila dit ça,537871,121365,416506,2005,0.22563960503540811,0.7743603949645919
5484,Kids in America,537667,537667,0,2005,1.0,0.0
5485,Grateful Dead Meet-Up 2019,537153,537153,0,2019,1.0,0.0
5486,Pretty Persuasion,537126,305800,231326,2005,0.5693263777958989,0.4306736222041011
5487,CatVideoFest,536566,470923,65643,2019,0.8776609028525848,0.12233909714741523
5488,Karwaan,536525,182009,354516,2018,0.3392367550440334,0.6607632449559666
5489,Intacto 2002 Re-release,535420,307333,228087,2002,0.5740035859698928,0.4259964140301072
5490,Hungry Hearts,534549,6921,527628,2015,0.012947363104224308,0.9870526368957757
5491,What They Had,533579,260136,273443,2018,0.4875304312950847,0.5124695687049153
5492,Creature,533235,508714,24521,2011,0.9540146464504393,0.0459853535495607
5493,Kill Your Friends,533147,0,533147,2015,0.0,1.0
5494,Kahaani 2,532877,350703,182174,2016,0.6581312385409767,0.3418687614590234
5495,Standing Ovation,531806,531806,0,2010,1.0,0.0
5496,Metropolis 2010 Re-release,529603,529603,0,2010,1.0,0.0
5497,Margaret Atwood: Live in Cinemas,529285,93690,435595,2019,0.177012384632098,0.822987615367902
5498,Evil,528245,15530,512715,2003,0.029399237096423062,0.9706007629035769
5499,Willy Wonka & the Chocolate Factory 2016 Re-release,526954,526633,321,2016,0.9993908386690299,0.0006091613309700657
5500,Dil Ka Rishta,526571,352128,174443,2003,0.6687189381868732,0.33128106181312683
5501,Only Yesterday 2016 Re-release,525958,453243,72715,2016,0.8617475159613506,0.13825248403864948
5502,Casa de los babys,525715,478031,47684,2003,0.9092968623683935,0.09070313763160648
5503,The Audience 2019 Re-release,523432,106529,416903,2019,0.20352022803344083,0.7964797719665592
5504,Bolshoi Ballet: Carmen Suite/Petrushka,522179,207523,314656,2019,0.39741736071347183,0.6025826392865282
5505,The Cremaster Cycle,522029,514622,7407,2003,0.9858111330979696,0.014188866902030348
5506,The Trials of Henry Kissinger,521266,516726,4540,2002,0.9912904352096626,0.008709564790337371
5507,Hawayein,521260,409978,111282,2003,0.7865134481832483,0.21348655181675172
5508,Sound City,521181,422853,98328,2013,0.8113361768752123,0.18866382312478774
5509,The Spy Behind Home Plate,519525,519525,0,2019,1.0,0.0
5510,Wild Nights with Emily,519487,519487,0,2019,1.0,0.0
5511,The Circle 2001 Re-release,519354,440554,78800,2001,0.8482730469005726,0.15172695309942735
5512,I'm Your Hero,519274,274579,244695,2014,0.528774789417533,0.4712252105824671
5513,Scatter My Ashes at Bergdorf's,518342,518342,0,2013,1.0,0.0
5514,Madison,517262,517262,0,2005,1.0,0.0
5515,Trespass Against Us,517197,5711,511486,2017,0.011042214088635472,0.9889577859113645
5516,Grave of the Fireflies,516962,516962,0,2018,1.0,0.0
5517,Listen to Me Marlon,516337,425831,90506,2015,0.824715253797423,0.175284746202577
5518,The Sandlot 2018 Re-release,516130,516130,0,2018,1.0,0.0
5519,"Love, Wedding, Marriage",515823,1926,513897,2011,0.003733838933122408,0.9962661610668776
5520,Preacher's Kid,515065,515065,0,2010,1.0,0.0
5521,A Hard Day's Night 2014 Re-release,515005,515005,0,2014,1.0,0.0
5522,Goodbye First Love,514913,95000,419913,2011,0.18449718690341863,0.8155028130965813
5523,Big Eden,512451,512451,0,2001,1.0,0.0
5524,Mifune,512434,512434,0,2000,1.0,0.0
5525,Bullitt 2018 Re-release,511350,511350,0,2018,1.0,0.0
5526,Black Butler: Book of the Atlantic,511132,248286,262846,2017,0.4857571038401039,0.514242896159896
5527,Monsters and Men,510967,500101,10866,2018,0.9787344388189453,0.021265561181054746
5528,Unsullied,510957,510957,0,2016,1.0,0.0
5529,Bol,509872,188850,321022,2011,0.3703870775410299,0.62961292245897
5530,Karmina 2,508969,508969,0,2001,1.0,0.0
5531,Saving Private Ryan 2019 Re-release,508694,508694,0,2019,1.0,0.0
5532,Una,508169,22815,485354,2017,0.04489648128870514,0.9551035187112948
5533,The Inevitable Defeat of Mister & Pete,506303,494608,11695,2013,0.9769011836785482,0.02309881632145178
5534,Our Last Tango,505885,100086,405799,2015,0.19784338337764512,0.8021566166223549
5535,Gabriel and the Mountain,505769,18415,487354,2017,0.03640990254444223,0.9635900974555578
5536,Manna from Heaven,505675,505675,0,2002,1.0,0.0
5537,Have a Nice Day,504003,79393,424610,2018,0.15752485600284125,0.8424751439971587
5538,Letters From Baghdad,502941,359735,143206,2017,0.7152628240688271,0.2847371759311728
5539,Chuck,502518,320725,181793,2017,0.6382358442881648,0.3617641557118352
5540,Amadeus Director's Cut,502511,408749,93762,2002,0.8134130397145535,0.1865869602854465
5541,Shaadi No. 1,502389,336772,165617,2005,0.6703411101755811,0.32965888982441893
5542,Deli Man,502294,502294,0,2015,1.0,0.0
5543,The Triumph of Love,501442,447267,54175,2002,0.8919615827952186,0.10803841720478141
5544,Bride Flight 2011 Re-release,501360,501360,0,2011,1.0,0.0
5545,Synonyms,501223,206003,295220,2019,0.411000692306618,0.5889993076933819
5546,His Secret Life,500930,215449,285481,2001,0.430098017687102,0.569901982312898
5547,Alice and Martin,500896,500896,0,2000,1.0,0.0
5548,CQ,499891,414358,85533,2002,0.8288966994804867,0.17110330051951325
5549,Smashed,499725,376597,123128,2012,0.7536084846665666,0.2463915153334334
5550,Time of the Wolf,499149,61439,437710,2003,0.12308749491634763,0.8769125050836524
5551,Hamari Adhuri Kahani,498774,235361,263413,2015,0.4718790474242843,0.5281209525757157
5552,Whisper of the Heart 2019 Re-release,498156,498156,0,2019,1.0,0.0
5553,The Five Senses,497091,497091,0,2000,1.0,0.0
5554,Kahlil Gibran's The Prophet 2015 Re-release,496914,370146,126768,2015,0.7448894577331289,0.25511054226687113
5555,Felix and Meira,496714,447353,49361,2015,0.9006249068880684,0.09937509311193161
5556,April and the Extraordinary World,495879,295488,200391,2015,0.5958873031525836,0.4041126968474164
5557,Nausicaä of the Valley of the Wind 2019 Re-release,495770,495770,0,2019,1.0,0.0
5558,Eden,494949,65460,429489,2014,0.13225605062339757,0.8677439493766025
5559,The Invisible Circus,494630,77578,417052,2001,0.1568404666114065,0.8431595333885935
5560,Steve Jobs: The Man in the Machine,494506,494506,0,2015,1.0,0.0
5561,À Tout de Suite,494030,248565,245465,2004,0.503137461287776,0.49686253871222397
5562,Monty Python's Life of Brian 2019 Re-release,493971,161507,332464,2019,0.32695644076271685,0.6730435592372832
5563,L'incomparable mademoiselle C.,493905,493905,0,2004,1.0,0.0
5564,The Polar Express 2013 IMAX Release,493776,493776,0,2013,1.0,0.0
5565,Rain,492661,455164,37497,2002,0.9238888403993821,0.07611115960061787
5566,Two Night Stand,492332,18612,473720,2014,0.03780375843942705,0.9621962415605729
5567,Soul on a String,491294,3669,487625,2017,0.007468033397517576,0.9925319666024824
5568,Wolves,491154,12139,479015,2014,0.024715262422783893,0.9752847375772161
5569,I'll Sleep When I'm Dead,490964,360759,130205,2004,0.734797256010624,0.265202743989376
5570,Tape,490475,490475,0,2001,1.0,0.0
5571,Joker,490291,169181,321110,2012,0.34506242211258215,0.6549375778874179
5572,Open Grave,489812,0,489812,2013,0.0,1.0
5573,Brothers,489706,389220,100486,2004,0.7948034126598408,0.2051965873401592
5574,Zama,489692,200600,289092,2017,0.40964524639977784,0.5903547536002222
5575,L'amour fou,489126,312494,176632,2010,0.638882414756116,0.361117585243884
5576,What Richard Did,488327,2749,485578,2012,0.0056294245454377905,0.9943705754545622
5577,Asa Nu Maan Watna Da: In Search of Our Roots,487893,235075,252818,2004,0.4818167098113726,0.5181832901886274
5578,At Any Price,487455,380594,106861,2013,0.7807777128145162,0.21922228718548378
5579,London Fields,487420,252676,234744,2018,0.5183948135078577,0.4816051864921423
5580,Beach Rats,486623,473771,12852,2017,0.973589411104695,0.02641058889530499
5581,Kisna: The Warrior Poet,485613,147000,338613,2005,0.3027101827998839,0.6972898172001162
5582,Cooties,485544,60058,425486,2015,0.12369218855551711,0.8763078114444829
5583,The Russian Five,485049,485049,0,2019,1.0,0.0
5584,In Praise of Love,485003,252074,232929,2001,0.5197369913175794,0.4802630086824205
5585,Our Little Sister 2016 Re-release,483559,467555,16004,2016,0.9669037283971552,0.03309627160284474
5586,Lawrence of Arabia 2019 Re-release,482281,482281,0,2019,1.0,0.0
5587,The Journey,482209,155475,326734,2017,0.32242243508520163,0.6775775649147984
5588,Tere Naal Love Ho Gaya,481796,177743,304053,2012,0.3689175501664605,0.6310824498335396
5589,I Origins,481234,336472,144762,2014,0.6991858430617953,0.3008141569382047
5590,Breathe In,481079,89661,391418,2013,0.1863747949920907,0.8136252050079094
5591,Father of My Children,480834,144022,336812,2010,0.29952540793704274,0.7004745920629573
5592,The Cuckoo,480578,243936,236642,2002,0.5075887785125411,0.49241122148745886
5593,The Third Man 2015 Re-release,478945,449191,29754,2015,0.9378759565294553,0.062124043470544635
5594,Brotherly Love,478595,478595,0,2015,1.0,0.0
5595,The Last September,478053,478053,0,2000,1.0,0.0
5596,Liam Gallagher: As It Was,477009,0,477009,2019,0.0,1.0
5597,Blue Car,476551,465310,11241,2003,0.9764117586575204,0.02358824134247961
5598,Heart of a Dog,476384,420813,55571,2015,0.8833483072479345,0.11665169275206556
5599,The Babymakers,475511,7889,467622,2012,0.016590573088740325,0.9834094269112597
5600,Producing Adults,474752,935,473817,2004,0.001969449312483149,0.9980305506875169
5601,On the Job,472890,164620,308270,2013,0.34811478356488823,0.6518852164351118
5602,"A White, White Day",471552,0,471552,2019,0.0,1.0
5603,Pearl Jam Twenty,471334,471334,0,2011,1.0,0.0
5604,Reconstruction,471107,73516,397591,2003,0.15604947496004093,0.843950525039959
5605,About Elly 2015 Re-release,470760,470760,0,2015,1.0,0.0
5606,White Bird in a Blizzard,469701,33821,435880,2014,0.07200538214736608,0.9279946178526339
5607,Matangi/Maya/M.I.A,469489,230808,238681,2018,0.49161535201037726,0.5083846479896228
5608,Joe Gould's Secret,468684,468684,0,2000,1.0,0.0
5609,DCI 2017 Tour Premeire,467817,467817,0,2017,1.0,0.0
5610,Time Freak,467693,10003,457690,2018,0.021387961761240814,0.9786120382387592
5611,Hail Satan?,467361,424284,43077,2019,0.9078292797216713,0.09217072027832875
5612,Tully,466664,466664,0,2002,1.0,0.0
5613,Last Days in Vietnam,466114,466114,0,2014,1.0,0.0
5614,Neighboring Sounds,465082,60255,404827,2012,0.1295577984097428,0.8704422015902572
5615,Venus Beauty,465080,465080,0,2000,1.0,0.0
5616,Ghanchakkar,464803,203044,261759,2013,0.43683883279582963,0.5631611672041704
5617,Puffs: Filmed Live Off Broadway,464483,464483,0,2018,1.0,0.0
5618,Rififi 2000 Re-release,463593,460226,3367,2000,0.9927371638484619,0.0072628361515380945
5619,Demonlover,462976,232044,230932,2002,0.5012009261819187,0.4987990738180813
5620,Deepsea Challenge,462959,235659,227300,2014,0.5090277972779447,0.4909722027220553
5621,Before We Go,462875,37151,425724,2015,0.08026140966783689,0.9197385903321631
5622,The Bag Man,461780,56574,405206,2014,0.12251288492355668,0.8774871150764433
5623,MFKZ,461724,229423,232301,2018,0.4968834195320148,0.5031165804679852
5624,Scotty and the Secret History of Hollywood,461689,461689,0,2018,1.0,0.0
5625,Outfoxed: Rupert Murdoch's War on Journalism,461572,461572,0,2004,1.0,0.0
5626,Bully,461405,279202,182203,2012,0.6051126450732003,0.39488735492679966
5627,Disorder,460997,51879,409118,2015,0.11253652409885531,0.8874634759011447
5628,Manglehorn,459636,143101,316535,2015,0.3113354915628889,0.6886645084371111
5629,Christmas Jars,459462,459462,0,2019,1.0,0.0
5630,Eric Clapton: A Life in 12 Bars,459088,0,459088,2017,0.0,1.0
5631,The Legend of Suriyothai,458564,454736,3828,2003,0.991652201219459,0.008347798780540993
5632,Shade,458144,25032,433112,2004,0.054637843123559404,0.9453621568764405
5633,The Memory of a Killer 2005 Re-release,458042,333707,124335,2005,0.7285510935678388,0.27144890643216124
5634,South Pacific 2018 Re-release,458000,458000,0,2018,1.0,0.0
5635,We Steal Secrets,457517,166243,291274,2013,0.3633591757246179,0.6366408242753822
5636,Paradise: Hope,457132,6701,450431,2013,0.014658785646159096,0.9853412143538409
5637,Sound of Noise,456366,24565,431801,2010,0.05382741045564306,0.9461725895443569
5638,Staying Vertical,456271,12158,444113,2016,0.026646444766377876,0.9733535552336221
5639,Lola Versus,455754,252603,203151,2012,0.5542529522505563,0.4457470477494438
5640,The Gospel According to André,454550,400713,53837,2018,0.881559784402156,0.11844021559784403
5641,The Most Dangerous Man in America: Daniel Ellsberg and the Pentagon Papers,453993,453993,0,2010,1.0,0.0
5642,Warm Water Under a Red Bridge,453754,71094,382660,2001,0.15667961053786852,0.8433203894621315
5643,The Safety of Objects,453292,319299,133993,2002,0.7044002541408187,0.29559974585918125
5644,Ten,452895,105990,346905,2002,0.23402775477759746,0.7659722452224026
5645,Leaning Into The Wind,452372,400530,51842,2018,0.8853996268557736,0.11460037314422643
5646,Sailor Moon R: The Movie: The Promise of the Rose,452053,452053,0,2017,1.0,0.0
5647,The Perfect Host,450885,48764,402121,2011,0.10815174601062355,0.8918482539893764
5648,Perfect Blue 2017 Re-release,450594,446062,4532,2017,0.9899421652307843,0.010057834769215747
5649,Kill List,450275,29063,421212,2011,0.06454500027760812,0.9354549997223919
5650,Pearl Jam: Let's Play Two,450273,348833,101440,2017,0.7747144510108313,0.2252855489891688
5651,Hesher,449702,382946,66756,2011,0.8515550297752734,0.1484449702247266
5652,17 Girls,449626,15123,434503,2011,0.033634620773709704,0.9663653792262903
5653,Lockdown,449482,449482,0,2003,1.0,0.0
5654,The Rocket,449064,56823,392241,2013,0.1265365293143071,0.8734634706856929
5655,Before We Vanish,448829,52087,396742,2017,0.11605087906530104,0.8839491209346989
5656,The Sleeping Beauty,446131,29066,417065,2011,0.06515126722868395,0.9348487327713161
5657,I Am Trying to Break Your Heart,445522,445522,0,2002,1.0,0.0
5658,Cruel Intentions 2019 Re-release,445218,445218,0,2019,1.0,0.0
5659,Baise-moi,444243,420224,24019,2000,0.9459327440162254,0.05406725598377465
5660,Charlie Countryman,443990,11650,432340,2013,0.026239329714633212,0.9737606702853668
5661,Modern Times 2003 Re-release,443427,163577,279850,2003,0.3688927376997792,0.6311072623002207
5662,It's All About Love,443400,6140,437260,2003,0.013847541723049165,0.9861524582769509
5663,Porco Rosso 2018 Re-release,443059,443059,0,2018,1.0,0.0
5664,The Beautiful Country 2005 Re-release,442813,442813,0,2005,1.0,0.0
5665,Prince Avalanche,442313,205139,237174,2013,0.46378695629565486,0.5362130437043451
5666,Elf 2018 Re-release,442073,442073,0,2018,1.0,0.0
5667,Aitraaz,440684,91998,348686,2004,0.20876183387642847,0.7912381661235716
5668,Bastards,439935,24525,415410,2013,0.05574687169695523,0.9442531283030448
5669,Short Cut to Nirvana: Kumbh Mela,439651,381225,58426,2004,0.8671082290271147,0.13289177097288532
5670,Bitch Slap,439587,17365,422222,2010,0.03950298803194817,0.9604970119680518
5671,Desert Dancer,438165,155271,282894,2014,0.3543665057683749,0.6456334942316251
5672,Dorm Daze,436365,56127,380238,2003,0.12862397305008422,0.8713760269499158
5673,My Kingdom,435759,36533,399226,2011,0.08383762584364293,0.916162374156357
5674,The Singing Detective,435625,337174,98451,2003,0.7740005738880918,0.22599942611190818
5675,The Wayward Cloud,435251,0,435251,2005,0.0,1.0
5676,We the Animals,434743,400961,33782,2018,0.9222943210126443,0.07770567898735575
5677,Moolaadé,434553,215646,218907,2004,0.4962478684993545,0.5037521315006455
5678,What We Left Behind: Star Trek DS9,434437,382457,51980,2019,0.8803508909231949,0.11964910907680515
5679,Chaos 2002 Re-release,434432,206789,227643,2002,0.47599854522687096,0.5240014547731291
5680,DCI 2018 Tour Premeire,434008,434008,0,2018,1.0,0.0
5681,Rosenwald,433924,433924,0,2015,1.0,0.0
5682,Bjork: Biophilia Live,433686,127754,305932,2014,0.29457718256987775,0.7054228174301223
5683,I Want Your Money,433588,433588,0,2010,1.0,0.0
5684,The Sower,433112,36233,396879,2018,0.08365734498236022,0.9163426550176398
5685,La petite Jérusalem,431623,53580,378043,2005,0.12413610952150372,0.8758638904784963
5686,Promises,430862,247948,182914,2002,0.5754696399311149,0.42453036006888517
5687,Harmony,430568,23248,407320,2015,0.0539937942438825,0.9460062057561175
5688,Ghostbusters 2019 Re-release,430435,369612,60823,2019,0.8586941117706506,0.1413058882293494
5689,Andy Irons: Kissed by God,430393,285933,144460,2018,0.6643532771211428,0.3356467228788572
5690,Go Goa Gone,429350,298457,130893,2013,0.6951368347502038,0.30486316524979623
5691,On the Beach at Night Alone,429159,37489,391670,2017,0.08735457021756506,0.9126454297824349
5692,Blackway,426491,27079,399412,2016,0.06349254732221782,0.9365074526777821
5693,Happy Bhaag Jayegi 2016 Re-release,426345,351840,74505,2016,0.825247158990958,0.17475284100904198
5694,Josh,426318,426318,0,2000,1.0,0.0
5695,Killing Sarai,425332,425332,0,2019,1.0,0.0
5696,8 ½ Women,424123,424123,0,2000,1.0,0.0
5697,Sound of My Voice,424088,408015,16073,2012,0.9620998472015242,0.037900152798475785
5698,Viva,423976,178008,245968,2016,0.41985395399739606,0.5801460460026039
5699,God Help the Girl,423306,102757,320549,2014,0.2427487444071192,0.7572512555928808
5700,Taking Sides,422832,188952,233880,2002,0.44687251674423883,0.5531274832557611
5701,Cirque du Soleil in Cinema: KURIOS - Cabinet of Curiosities,422760,413039,9721,2018,0.9770058662125083,0.02299413378749172
5702,Mississippi Grind,422746,130541,292205,2015,0.3087929868053157,0.6912070131946842
5703,Behaving Badly,422697,0,422697,2014,0.0,1.0
5704,Ben-Hur 2019 Re-release,422622,422622,0,2019,1.0,0.0
5705,Super,422618,327716,94902,2011,0.7754425982802436,0.22455740171975638
5706,Settai,422247,87838,334409,2013,0.20802516062873153,0.7919748393712684
5707,Mad Max: Fury Road 2016 Re-release,421986,421986,0,2016,1.0,0.0
5708,She's Beautiful When She's Angry,421573,421573,0,2014,1.0,0.0
5709,Porn Star: The Legend of Ron Jeremy,421516,421516,0,2001,1.0,0.0
5710,The Bounce Back,421404,321910,99494,2016,0.7638987764710349,0.23610122352896507
5711,The Cold Blue,420177,420177,0,2019,1.0,0.0
5712,Voiceless,419952,419952,0,2016,1.0,0.0
5713,Madame Satã,419046,198309,220737,2002,0.47323921478787534,0.5267607852121247
5714,Amandla! A Revolution in Four Part Harmony,418941,405331,13610,2003,0.9675133252653715,0.032486674734628504
5715,Frankenstein 2018 Re-release,417783,417783,0,2018,1.0,0.0
5716,Happy Phirr Bhag Jayegi,417669,103385,314284,2018,0.2475285453313509,0.7524714546686491
5717,In the Realms of the Unreal,417120,417120,0,2004,1.0,0.0
5718,Dirty Wars,416853,384473,32380,2013,0.922322737271892,0.07767726272810799
5719,Tales of Halloween,416792,0,416792,2015,0.0,1.0
5720,Manifesto,416389,161101,255288,2017,0.3869002303134809,0.6130997696865191
5721,Status Update,416178,4764,411414,2018,0.011447025071003272,0.9885529749289967
5722,Sand Storm,414698,86800,327898,2016,0.20930894289338264,0.7906910571066174
5723,Wonderland,414254,414254,0,2000,1.0,0.0
5724,The Ottoman Lieutenant,413844,240978,172866,2017,0.5822918780989939,0.4177081219010062
5725,The Mafia Kills Only in Summer 2015 Re-release,413236,37134,376102,2015,0.08986148351063315,0.9101385164893668
5726,The Moth Diaries,413035,3838,409197,2012,0.009292190734441392,0.9907078092655586
5727,Unbranded,412792,410185,2607,2015,0.9936844706292758,0.006315529370724239
5728,Godzilla,412520,412520,0,2004,1.0,0.0
5729,Rage,411967,5594,406373,2010,0.013578757521840342,0.9864212424781597
5730,Tuvalu,411678,411678,0,2001,1.0,0.0
5731,R... Rajkumar,410495,166503,243992,2013,0.4056151719265764,0.5943848280734235
5732,El bonaerense,410474,9470,401004,2002,0.023070888777364705,0.9769291112226353
5733,Free Zone,410392,32381,378011,2005,0.07890261018733309,0.9210973898126669
5734,Mobsters and Mormons,409604,409604,0,2005,1.0,0.0
5735,City of Revenge,409166,409166,0,2015,1.0,0.0
5736,Song One,408918,32251,376667,2015,0.0788691131229244,0.9211308868770756
5737,The Reliant,408747,408747,0,2019,1.0,0.0
5738,Sleeping Beauty,408680,36578,372102,2011,0.08950278946853284,0.9104972105314671
5739,Vertigo 2018 Re-release,408560,394212,14348,2018,0.9648815351478363,0.035118464852163696
5740,The 5th Quarter,408159,408159,0,2011,1.0,0.0
5741,Le Cercle Rouge,407878,369970,37908,2002,0.9070604445446923,0.09293955545530772
5742,"Love, Kennedy",407871,407871,0,2017,1.0,0.0
5743,Cinema Paradiso 2002 Re-release,406809,406809,0,2002,1.0,0.0
5744,Please Stand By,406732,9868,396864,2018,0.024261675993037184,0.9757383240069628
5745,Chasing Trane: The John Coltrane Documentary,406284,406284,0,2017,1.0,0.0
5746,Gabrielle,406256,5534,400722,2013,0.013621952660391477,0.9863780473396085
5747,Every Heart That Loves,406235,406235,0,2000,1.0,0.0
5748,The Square 2010 Re-release,406116,406116,0,2010,1.0,0.0
5749,The Hunting Ground,405917,405917,0,2015,1.0,0.0
5750,The Tempest,405861,277943,127918,2010,0.6848231291008497,0.3151768708991502
5751,Stake Land,405380,33245,372135,2011,0.08200947259361586,0.9179905274063841
5752,Happy Magic,405268,10697,394571,2011,0.02639487943780412,0.9736051205621958
5753,Tezz,405214,229931,175283,2012,0.5674310364400046,0.43256896355999547
5754,The Philadelphia Story 2018 Re-release,404524,404524,0,2018,1.0,0.0
5755,God's Pocket,403713,169976,233737,2014,0.4210317725711087,0.5789682274288913
5756,A Wake in Providence,403069,403069,0,2005,1.0,0.0
5757,The Apu Trilogy,402723,402723,0,2015,1.0,0.0
5758,The Brown Bunny,402599,366301,36298,2004,0.9098408093413048,0.09015919065869513
5759,Raju Chacha,402226,194698,207528,2000,0.48405125476722044,0.5159487452327796
5760,Gang Land,402000,402000,0,2000,1.0,0.0
5761,Drinking Buddies,401914,343341,58573,2013,0.8542648427275487,0.14573515727245132
5762,The Oath,401463,401463,0,2018,1.0,0.0
5763,Freetown,401328,401328,0,2015,1.0,0.0
5764,An Affair of Love,401299,359050,42249,2000,0.8947193987525511,0.10528060124744891
5765,"Hello, Dolly!",400881,400881,0,2019,1.0,0.0
5766,Crimson Gold,400768,148959,251809,2004,0.37168386697540723,0.6283161330245928
5767,Racer and the Jailbird,400026,46337,353689,2017,0.11583497072690276,0.8841650292730973
5768,The Mystic Masseur,399110,399110,0,2002,1.0,0.0
5769,West Side Story 2018 Re-release,398670,398670,0,2018,1.0,0.0
5770,Space Mutiny,397887,397887,0,2018,1.0,0.0
5771,Berlin Syndrome,397783,28660,369123,2017,0.07204933343053876,0.9279506665694612
5772,Krull 2018 Re-release,397157,397157,0,2018,1.0,0.0
5773,Lost and Delirious,396897,307233,89664,2001,0.7740874836544493,0.2259125163455506
5774,Still We Believe: The Boston Red Sox Movie,396803,396803,0,2004,1.0,0.0
5775,Very Annie Mary,396090,46352,349738,2002,0.11702390870761696,0.8829760912923831
5776,13 Minutes 2015 Re-release,395557,161531,234026,2015,0.40836339642579955,0.5916366035742004
5777,Pauline and Paulette,395175,139789,255386,2001,0.3537394825077497,0.6462605174922502
5778,Keane,394390,33256,361134,2005,0.08432262481300236,0.9156773751869977
5779,The Yes Men,394154,255364,138790,2004,0.6478787479005668,0.35212125209943324
5780,God Bless America,393880,122550,271330,2012,0.3111353711790393,0.6888646288209607
5781,Into the Abyss,393714,223880,169834,2011,0.5686361165719278,0.43136388342807214
5782,Millennium Mambo,393351,14904,378447,2001,0.037889823592669146,0.9621101764073309
5783,Jee Aayan Nu,393117,393117,0,2002,1.0,0.0
5784,Cuban Fury 2014 Re-release,392705,92384,300321,2014,0.235250378783056,0.764749621216944
5785,Hamara Dil Aapke Paas Hai,392076,392076,0,2000,1.0,0.0
5786,Three,391957,331507,60450,2016,0.8457738986674559,0.15422610133254414
5787,End of the Century,391950,391950,0,2004,1.0,0.0
5788,Tiny Furniture,391674,391674,0,2010,1.0,0.0
5789,Bittersweet Motel,391653,391653,0,2000,1.0,0.0
5790,The Escape,390881,14018,376863,2018,0.03586257710147078,0.9641374228985292
5791,Detropia,390024,390024,0,2012,1.0,0.0
5792,Once Upon a Time in Mumbaai Dobara,389237,0,389237,2013,0.0,1.0
5793,House of D,389199,388532,667,2005,0.9982862237569984,0.0017137762430016522
5794,The Game of Their Lives,388998,375750,13248,2005,0.9659432696312064,0.03405673036879367
5795,Singh Saab the Great,388622,225668,162954,2013,0.580687660503008,0.4193123394969919
5796,Keep the Lights On,388331,246112,142219,2012,0.6337686149187163,0.3662313850812838
5797,The Shawshank Redemption 2019 Re-release,387095,358507,28588,2019,0.9261473281752541,0.07385267182474586
5798,"Westwood: Punk, Icon, Activist",386856,58979,327877,2018,0.15245724507310213,0.8475427549268979
5799,Hitchcock/Truffaut,386471,260430,126041,2015,0.6738668619378945,0.3261331380621056
5800,The Wedding Guest,386166,386166,0,2019,1.0,0.0
5801,How to Talk to Girls at Parties,385733,84809,300924,2018,0.21986451768451235,0.7801354823154877
5802,Samurai Cop,384756,384756,0,2017,1.0,0.0
5803,Bethlehem,384670,201700,182970,2014,0.5243455429329035,0.47565445706709647
5804,The Embalmer,384336,56878,327458,2002,0.1479903001540319,0.8520096998459681
5805,The Secret World of Arrietty 2019 Re-release,384289,384289,0,2019,1.0,0.0
5806,"Scotland, Pa.",384098,384098,0,2002,1.0,0.0
5807,Imagining Argentina,383106,8899,374207,2003,0.02322855815361806,0.976771441846382
5808,Into the Arms of Strangers,382807,382807,0,2000,1.0,0.0
5809,Digimon Adventure tri. Part 5: Coexistence,382119,52339,329780,2017,0.1369704202094112,0.8630295797905888
5810,Game,381911,139528,242383,2011,0.3653416633718327,0.6346583366281673
5811,Z for Zachariah,381839,121461,260378,2015,0.3180947991169053,0.6819052008830947
5812,The Children of the Century,381624,56611,325013,2002,0.14834234744146071,0.8516576525585393
5813,Flower,380553,328188,52365,2018,0.8623976161007797,0.13760238389922033
5814,Jane and Emma,380030,380030,0,2018,1.0,0.0
5815,Daughter of Mine,379010,10628,368382,2018,0.02804147647819319,0.9719585235218068
5816,I'll Push You: A Real-Life Inspiration,378899,378899,0,2017,1.0,0.0
5817,Blind Spot. Hitler's Secretary,378382,378382,0,2003,1.0,0.0
5818,Miss Hokusai,377702,222670,155032,2015,0.589538842791407,0.410461157208593
5819,Attack on Titan: Smoke Signal,377334,377334,0,2018,1.0,0.0
5820,Pride and Prejudice,377271,377271,0,2003,1.0,0.0
5821,Hochelaga,376714,376714,0,2000,1.0,0.0
5822,The Hunting of the President,376612,376612,0,2004,1.0,0.0
5823,The Nightmare Before Christmas 2000 Re-release,376586,376586,0,2000,1.0,0.0
5824,Le talent de mes amis,376522,889,375633,2015,0.0023610838144915835,0.9976389161855084
5825,Born Romantic,376090,15545,360545,2001,0.04133319152330559,0.9586668084766944
5826,Great Performances at the Met: Puccini: Turandot,375295,0,375295,2019,0.0,1.0
5827,Chronic,374704,9033,365671,2016,0.024107028481147787,0.9758929715188522
5828,Annie Brocoli dans les fonds marins,374360,374360,0,2003,1.0,0.0
5829,Waking Up in Reno,374312,267109,107203,2002,0.713599884588258,0.2864001154117421
5830,Jurassic Park 2018 Re-release,374238,374238,0,2018,1.0,0.0
5831,Keep the River on Your Right: A Modern Cannibal Tale,373366,373366,0,2001,1.0,0.0
5832,Nico and Dani,372850,370562,2288,2001,0.9938634839747887,0.006136516025211211
5833,Pom Poko 2018 Re-release,372405,372405,0,2018,1.0,0.0
5834,Eloise,372137,0,372137,2017,0.0,1.0
5835,Fanny,371657,8735,362922,2013,0.023502853437443665,0.9764971465625564
5836,Havoc,371000,0,371000,2005,0.0,1.0
5837,7 Boxes,370892,38106,332786,2013,0.10274149887298728,0.8972585011270127
5838,Hava Nagila,370218,370218,0,2013,1.0,0.0
5839,Me Myself I,369975,369975,0,2000,1.0,0.0
5840,"Ruben Brandt, Collector 2018 Re-release",369809,117963,251846,2018,0.31898358341738575,0.6810164165826142
5841,Me Without You,369226,304909,64317,2001,0.825805874992552,0.17419412500744802
5842,Mooz-Lum,369129,369129,0,2011,1.0,0.0
5843,When Comedy Went to School,369065,369065,0,2013,1.0,0.0
5844,The Void,368372,151042,217330,2017,0.41002573485498356,0.5899742651450165
5845,Dark Awakening,367925,0,367925,2015,0.0,1.0
5846,Room 237,367406,296359,71047,2012,0.8066253681213699,0.1933746318786302
5847,The Big White,367241,0,367241,2005,0.0,1.0
5848,INXS: Baby Live at Wembly Stadium,366425,161750,204675,2019,0.44142730435969163,0.5585726956403084
5849,The Animation Show,366344,366344,0,2003,1.0,0.0
5850,Grease 2010 Sing-a-long,365802,365802,0,2010,1.0,0.0
5851,Baadasssss!,365727,365727,0,2004,1.0,0.0
5852,Seven Sins Forgiven,365672,270207,95465,2011,0.7389327047189831,0.26106729528101685
5853,Eat That Question,365540,355074,10466,2016,0.9713683864966899,0.02863161350331017
5854,Glen Campbell: I'll Be Me,365422,365422,0,2014,1.0,0.0
5855,Lords of Chaos,365353,253184,112169,2019,0.692984592982677,0.307015407017323
5856,Your Magical Spell Worked,365318,365318,0,2000,1.0,0.0
5857,Clemency,364716,364716,0,2019,1.0,0.0
5858,BOSTON: An American Running Story,364369,364369,0,2017,1.0,0.0
5859,The Adventures of Felix,363409,363409,0,2001,1.0,0.0
5860,Jig,363320,183790,179530,2011,0.5058626004624023,0.4941373995375977
5861,The Breadwinner,363307,312381,50926,2017,0.8598265378866908,0.14017346211330914
5862,Scorched,363057,8000,355057,2003,0.022035107434920688,0.9779648925650793
5863,Breathless 2010 Re-release,363031,363031,0,2010,1.0,0.0
5864,Happy Times,361000,240093,120907,2002,0.6650775623268698,0.3349224376731302
5865,The Tobacconist,360996,0,360996,2019,0.0,1.0
5866,Grateful Dawg,360251,360251,0,2001,1.0,0.0
5867,These Final Hours,360234,0,360234,2014,0.0,1.0
5868,Souvenir,359798,11411,348387,2016,0.031715017871138805,0.9682849821288612
5869,Disney Junior HalloVeen Party!,359745,359745,0,2017,1.0,0.0
5870,Happy Ending,359542,313770,45772,2014,0.8726935935161956,0.1273064064838044
5871,K-12,359377,303230,56147,2019,0.8437657390428436,0.15623426095715642
5872,Government 3,358928,249588,109340,2017,0.695370659296572,0.304629340703428
5873,Love in Space,358486,34787,323699,2011,0.09703865701868414,0.9029613429813159
5874,Everly,358156,0,358156,2015,0.0,1.0
5875,Welcome to the Rileys,358014,158898,199116,2010,0.4438318054601217,0.5561681945398783
5876,National Gallery,354971,253941,101030,2014,0.715385200481166,0.28461479951883395
5877,Hello I Must Be Going,354939,106709,248230,2012,0.3006403917292831,0.699359608270717
5878,The Invitation,354835,231737,123098,2016,0.6530838276945623,0.34691617230543775
5879,Kaashmora,354631,327959,26672,2016,0.9247894290121281,0.0752105709878719
5880,Las Acacias,354391,6000,348391,2011,0.016930452522778514,0.9830695474772215
5881,The Tomorrow Man,354103,354103,0,2019,1.0,0.0
5882,"Broadway: The Golden Age, by the Legends Who Were There",353580,353580,0,2004,1.0,0.0
5883,Howards End 2016 Re-release,353525,160282,193243,2016,0.4533823633406407,0.5466176366593594
5884,How My Mother Gave Birth to Me During Menopause,353275,353275,0,2003,1.0,0.0
5885,Like Dandelion Dust,352810,352810,0,2010,1.0,0.0
5886,Lumumba,352296,352296,0,2001,1.0,0.0
5887,Long Strange Trip - The Untold Story of The Grateful Dead,351957,351957,0,2017,1.0,0.0
5888,The Wizard of Oz 2018 Re-release,351839,351839,0,2018,1.0,0.0
5889,Yossi & Jagger,351707,267005,84702,2003,0.7591688536196323,0.24083114638036776
5890,The Chumscrubber,351401,52597,298804,2005,0.14967800319293342,0.8503219968070665
5891,Bel Canto,350264,125569,224695,2018,0.35849816138683965,0.6415018386131603
5892,Aferim!,350110,108110,242000,2015,0.3087886664191254,0.6912113335808746
5893,Tehran Taboo,349886,74758,275128,2017,0.21366387909204712,0.7863361209079529
5894,Satanic,349183,252,348931,2016,0.0007216846180942371,0.9992783153819058
5895,Marie's Story 2014 Re-release,348906,11720,337186,2014,0.03359070924547013,0.9664092907545299
5896,Suicide the Ripple Effect,347468,347468,0,2018,1.0,0.0
5897,The Good Heart,346851,20930,325921,2010,0.06034291381601898,0.939657086183981
5898,The Vault,346729,5728,341001,2017,0.016520106480853922,0.9834798935191461
5899,Star Trek: The Motion Picture 2019 Re-release,346243,346243,0,2019,1.0,0.0
5900,Triple Threat,345900,76289,269611,2019,0.2205521827117664,0.7794478172882336
5901,Billabong Odyssey,345708,156000,189708,2003,0.4512478739282863,0.5487521260717138
5902,Bear Cub,345693,100133,245560,2004,0.2896587434515596,0.7103412565484404
5903,Anatomy of Hell,345365,34506,310859,2004,0.09991168763482113,0.9000883123651788
5904,The Dying Gaul,345041,342747,2294,2005,0.9933515147475228,0.006648485252477242
5905,American Adobo,344992,344992,0,2002,1.0,0.0
5906,The United States of Leland,343847,343847,0,2004,1.0,0.0
5907,Countdown to Canelo vs. Chavez Jr.,343387,343387,0,2017,1.0,0.0
5908,El Bulli: Cooking in Progress,343116,237181,105935,2011,0.6912560183727952,0.3087439816272048
5909,The Idol,343059,0,343059,2016,0.0,1.0
5910,Koch,342941,342941,0,2013,1.0,0.0
5911,"Life, Animated",342664,255388,87276,2016,0.7453015198561856,0.25469848014381435
5912,Lawrence of Arabia 2002 Re-release,342481,342481,0,2002,1.0,0.0
5913,Nureyev: Lifting the Curtain,342255,165203,177052,2018,0.482689807307417,0.517310192692583
5914,Bolshoi Ballet: Swan Lake,341946,88905,253041,2018,0.25999719253917286,0.7400028074608271
5915,Knife + Heart,341847,32516,309331,2018,0.09511857643916723,0.9048814235608328
5916,Dangerous People,341280,341280,0,2002,1.0,0.0
5917,The Lady in the Car with Glasses and a Gun,339461,2167,337294,2015,0.006383649373565741,0.9936163506264343
5918,The Green Prince,339208,258237,80971,2014,0.7612939553312422,0.2387060446687578
5919,Happy People: A Year in the Taiga,338987,338987,0,2013,1.0,0.0
5920,Red Hook Summer,338803,338803,0,2012,1.0,0.0
5921,Is It Wrong to Try to Pick Up Girls in a Dungeon - Arrow of the Orion,338632,271489,67143,2019,0.80172281414633,0.19827718585367007
5922,Silencio,338596,158723,179873,2018,0.46876808940448206,0.531231910595518
5923,Freaks,338283,276591,61692,2019,0.8176319826890502,0.1823680173109497
5924,Winter Solstice,337617,319355,18262,2005,0.9459091218747872,0.05409087812521289
5925,Ran 2000 Re-release,337587,337587,0,2000,1.0,0.0
5926,Dark Horse,337150,166228,170922,2012,0.4930387068070592,0.5069612931929408
5927,The Last Waltz 2002 Re-release,337085,322313,14772,2002,0.956177225328923,0.04382277467107703
5928,Voyage of Time: The IMAX Experience,337038,55409,281629,2016,0.16439985995644407,0.8356001400435559
5929,First Love,336756,218329,118427,2019,0.6483299480929813,0.3516700519070187
5930,Kings of Pastry,336386,336386,0,2010,1.0,0.0
5931,Diane,336166,336166,0,2019,1.0,0.0
5932,Wooly Boys,335726,335726,0,2004,1.0,0.0
5933,Sailor Moon R: The Movie: The Promise of the Rose/Sailor Moon S: The Movie - Hearts in Ice,335697,335697,0,2018,1.0,0.0
5934,Russ Taff: I Still Believe,334983,334983,0,2018,1.0,0.0
5935,Anthropocene: The Human Epoch,334162,104806,229356,2019,0.3136382951981374,0.6863617048018625
5936,A Silent Voice: The Movie 2019 Re-release,333984,333984,0,2019,1.0,0.0
5937,Dark Days,333843,309648,24195,2000,0.9275258130318743,0.07247418696812574
5938,Ballet 422,333554,333554,0,2015,1.0,0.0
5939,Something from Nothing: The Art of Rap,333388,288000,45388,2012,0.8638583272343335,0.13614167276566644
5940,Shine,333388,333388,0,2018,1.0,0.0
5941,Linsanity,332990,302645,30345,2013,0.9088711372713896,0.09112886272861047
5942,Don't Hang Up,332571,0,332571,2017,0.0,1.0
5943,Shamitabh,331821,324597,7224,2015,0.9782292259983545,0.021770774001645465
5944,I Am David,329577,288552,41025,2004,0.8755222603519056,0.12447773964809437
5945,Bukowski: Born into This,329097,318816,10281,2004,0.968759970464635,0.031240029535364953
5946,The Big Fight Live: IBF Welterweight Title: Errol Spence Jr. vs. Mikey Garcia,328979,328979,0,2019,1.0,0.0
5947,Ladies vs. Ricky Bahl,328870,0,328870,2011,0.0,1.0
5948,The Last Sentence,328005,62506,265499,2012,0.19056416822914285,0.8094358317708572
5949,Elaine Stritch: Shoot Me,327452,327452,0,2014,1.0,0.0
5950,Come Undone,326484,326484,0,2001,1.0,0.0
5951,You Will Be My Son 2012 Re-release,326061,285151,40910,2012,0.8745326794679523,0.12546732053204768
5952,Formosa Betrayed,326034,225341,100693,2010,0.6911579773888613,0.3088420226111387
5953,Lucy in the Sky,325950,319976,5974,2019,0.9816720355882804,0.018327964411719588
5954,The Central Park Five,325653,325653,0,2012,1.0,0.0
5955,The Opera House,325235,320079,5156,2018,0.9841468476639968,0.015853152336003196
5956,Camp,324977,324977,0,2013,1.0,0.0
5957,Juan of the Dead,324834,18000,306834,2012,0.05541291859842258,0.9445870814015774
5958,Teefa In Trouble,324633,0,324633,2018,0.0,1.0
5959,Red Hill,324424,21087,303337,2010,0.06499827386383251,0.9350017261361675
5960,The Bolshoi Ballet: Live From Moscow - The Nutcracker,323928,323928,0,2018,1.0,0.0
5961,The Boys of Baraka,323860,323860,0,2005,1.0,0.0
5962,The Cured,323776,26630,297146,2018,0.08224822099229097,0.917751779007709
5963,Three Worlds,323748,3952,319796,2012,0.012207025217144198,0.9877929747828558
5964,Sword of Trust,323369,322421,948,2019,0.9970683646236962,0.002931635376303851
5965,Damsel,323235,305136,18099,2018,0.944006682444661,0.055993317555339
5966,Citizen Jane: Battle for the City,323124,313411,9713,2017,0.9699403325039304,0.03005966749606962
5967,Winter Sleepers,323041,323041,0,2000,1.0,0.0
5968,The Day He Arrives,322348,13746,308602,2011,0.042643354387184036,0.957356645612816
5969,In This World,322097,84299,237798,2003,0.26171929574010316,0.7382807042598969
5970,Nocturama,321768,30157,291611,2016,0.09372280649411999,0.90627719350588
5971,The Weight of Water,321279,109130,212149,2001,0.33967361701200516,0.6603263829879948
5972,Double Trouble,321081,44788,276293,2012,0.13949128101631675,0.8605087189836832
5973,Woodstock,320610,126562,194048,2019,0.39475375066279905,0.605246249337201
5974,A Film Unfinished,320486,320486,0,2010,1.0,0.0
5975,Cunningham,320293,265102,55191,2019,0.827685900097723,0.17231409990227697
5976,"Die, Mommie, Die!",320092,320092,0,2003,1.0,0.0
5977,The English Teacher,320013,104810,215203,2013,0.3275179445835013,0.6724820554164987
5978,Meeting Gorbachev,319230,251837,67393,2019,0.7888888888888889,0.2111111111111111
5979,You Are Here: A Come From Away Story,318885,318885,0,2019,1.0,0.0
5980,Neal 'n' Nikki,318860,111551,207309,2005,0.34984319136925296,0.650156808630747
5981,Bride of the Wind,318823,318823,0,2001,1.0,0.0
5982,The Yellow Handkerchief,318623,318623,0,2010,1.0,0.0
5983,West of Memphis,318317,310154,8163,2012,0.9743557522846722,0.025644247715327802
5984,Ask Dr. Ruth,318230,297195,21035,2019,0.9339000094271439,0.06609999057285611
5985,The Student,318123,1126,316997,2016,0.003539511446830314,0.9964604885531697
5986,Not Today,318121,318121,0,2013,1.0,0.0
5987,Today's Special,317831,317831,0,2010,1.0,0.0
5988,Inch'Allah,317656,9840,307816,2013,0.030976905835243155,0.9690230941647568
5989,Sauvage / Wild,317536,61604,255932,2018,0.19400634888642548,0.8059936511135746
5990,6 Days,316946,0,316946,2017,0.0,1.0
5991,5 Days of War,316944,17479,299465,2011,0.05514854359129689,0.9448514564087032
5992,AmeriGeddon,316554,316554,0,2016,1.0,0.0
5993,The Aryan Couple,316527,290211,26316,2005,0.9168601730658048,0.0831398269341952
5994,Corpo Celeste 2011 Re-release,316504,8919,307585,2011,0.028179738644693274,0.9718202613553067
5995,The Riot and the Dance,316103,316103,0,2018,1.0,0.0
5996,David and Goliath,316100,316100,0,2015,1.0,0.0
5997,Under the Sun,316020,316020,0,2001,1.0,0.0
5998,Action Jackson,315609,256872,58737,2014,0.8138931399294697,0.18610686007053032
5999,Josh Groban Bridges Live from Madison Square Garden,315173,315173,0,2019,1.0,0.0
6000,Obit.,315049,315049,0,2017,1.0,0.0
6001,Call,314701,314701,0,2000,1.0,0.0
6002,America's Heart & Soul,314402,314402,0,2004,1.0,0.0
6003,Elevator to the Gallows,314387,263404,50983,2005,0.8378336254361662,0.16216637456383376
6004,Time Out of Mind,314082,166775,147307,2015,0.5309919065721691,0.46900809342783095
6005,Russian Doll,313901,127103,186798,2001,0.40491428826285997,0.5950857117371401
6006,Christine,313465,298525,14940,2016,0.9523391766225895,0.04766082337741056
6007,War Witch,313387,70544,242843,2012,0.22510187084977998,0.77489812915022
6008,The Bolshoi Ballet: Live From Moscow - Romeo and Juliet,313088,313088,0,2018,1.0,0.0
6009,Grass,313039,313039,0,2000,1.0,0.0
6010,Berberian Sound Studio,312757,38493,274264,2012,0.1230763819834568,0.8769236180165432
6011,The Hornet's Nest,312706,312706,0,2014,1.0,0.0
6012,The Gatekeeper,312434,312434,0,2003,1.0,0.0
6013,David Lynch: The Art Life,311470,171419,140051,2017,0.5503547693196776,0.44964523068032236
6014,Plácido Domingo Gala,311246,52502,258744,2019,0.16868329231540324,0.8313167076845968
6015,Dancing in Jaffa,311001,151098,159903,2014,0.48584409696431846,0.5141559030356816
6016,Being Elmo: A Puppeteer's Journey,310812,304052,6760,2011,0.9782505179980181,0.021749482001981905
6017,I Am Eleven 2014 Re-release,310116,310116,0,2014,1.0,0.0
6018,Pumpkin,308552,308552,0,2002,1.0,0.0
6019,The Amazing Catfish,308349,11342,297007,2014,0.03678299589101959,0.9632170041089804
6020,Merchants of Doubt,308156,308156,0,2015,1.0,0.0
6021,MET Opera: Magic Flute,307686,307686,0,2018,1.0,0.0
6022,Never Again,307631,307631,0,2002,1.0,0.0
6023,Dot the I,307486,307486,0,2005,1.0,0.0
6024,The Trip,306567,306567,0,2003,1.0,0.0
6025,Half of a Yellow Sun,306393,54529,251864,2014,0.17797077609475412,0.8220292239052459
6026,The Mercy 2018 Re-release,306205,29538,276667,2018,0.09646478666253,0.90353521333747
6027,Monsters: Dark Continent,306004,0,306004,2015,0.0,1.0
6028,Under the Sun,305993,105036,200957,2016,0.3432627543767341,0.6567372456232659
6029,The Third Wife,305755,84933,220822,2019,0.27778123006982713,0.7222187699301729
6030,Hair Show,305281,305281,0,2004,1.0,0.0
6031,Happiness,305205,305205,0,2003,1.0,0.0
6032,Showtime Championship Boxing: Deontay Wilder vs. Tyson Fury,304482,304482,0,2018,1.0,0.0
6033,Microbe & Gasoline,303787,63802,239985,2015,0.21002215368004556,0.7899778463199545
6034,N.H 10,303587,303587,0,2015,1.0,0.0
6035,Alamar,303574,61613,241961,2010,0.20295875140822336,0.7970412485917766
6036,The Bolshoi Ballet: Live From Moscow - Giselle,302681,302681,0,2018,1.0,0.0
6037,101 Reykjavík 2001 Re-release,301882,126404,175478,2001,0.4187198971783677,0.5812801028216323
6038,The Unknown Known,301604,276497,25107,2014,0.9167550828238352,0.08324491717616478
6039,Cliffs of Freedom,300842,72476,228366,2019,0.2409105111653293,0.7590894888346706
6040,Series 7: The Contenders,300086,195065,105021,2001,0.6500303246402698,0.3499696753597302
6041,Love's Labour's Lost,299792,299792,0,2000,1.0,0.0
6042,Sunset Blvd. 2018 Re-release,299645,299645,0,2018,1.0,0.0
6043,Cotton Mary,299432,299432,0,2000,1.0,0.0
6044,Kedma,299293,10067,289226,2002,0.033635935354318344,0.9663640646456817
6045,Festival in Cannes,299171,299171,0,2002,1.0,0.0
6046,Zhou Yu's Train 2004 Re-release,298429,142562,155867,2004,0.4777082656176176,0.5222917343823824
6047,Jinn,297381,202348,95033,2014,0.6804335179449931,0.3195664820550069
6048,Kaptaan,296715,203790,92925,2016,0.6868206865173652,0.31317931348263484
6049,Bonhoeffer,296181,296181,0,2003,1.0,0.0
6050,The We and the I,295930,42172,253758,2012,0.1425066738755787,0.8574933261244213
6051,Trixie,295683,295683,0,2000,1.0,0.0
6052,Chic!,295295,5587,289708,2015,0.018920062987859598,0.9810799370121404
6053,Beats,295231,0,295231,2019,0.0,1.0
6054,Wet Hot American Summer,295206,295206,0,2001,1.0,0.0
6055,The Tenth Man,295129,63564,231565,2016,0.21537700463187284,0.7846229953681272
6056,Mickey,294758,294758,0,2004,1.0,0.0
6057,Aftershock,294696,58510,236186,2013,0.19854358389662569,0.8014564161033744
6058,Shakira in Concert: El Dorado World Tour,294677,271586,23091,2019,0.9216396257597301,0.07836037424026986
6059,Khodorkovsky,294599,39522,255077,2011,0.1341552415317092,0.8658447584682908
6060,Special Treatment,294483,8856,285627,2010,0.0300730432656554,0.9699269567343446
6061,44 Inch Chest 2010 Re-release,294245,39033,255212,2010,0.1326547604887084,0.8673452395112916
6062,Karthik Calling Karthik,293499,286409,7090,2010,0.975843188562823,0.024156811437176958
6063,Okko's Inn,293385,134787,158598,2018,0.4594202157574518,0.5405797842425482
6064,The Giant Spider Invasion,293053,293053,0,2019,1.0,0.0
6065,Pianomania,292870,49852,243018,2010,0.17021886843992215,0.8297811315600778
6066,Stonewall,292669,187674,104995,2015,0.6412500128131097,0.35874998718689033
6067,Luminarias,292309,292309,0,2000,1.0,0.0
6068,Mesrine Part 2: Public Enemy #1 2010 Re-release,292150,275387,16763,2010,0.9426219407838439,0.05737805921615608
6069,The Last Five Years,292092,145427,146665,2015,0.4978808046779782,0.5021191953220219
6070,Dreams of a Life,291898,8405,283493,2011,0.02879430485991682,0.9712056951400831
6071,The Man in 3B,291513,291513,0,2015,1.0,0.0
6072,The King of Staten Island,291440,0,291440,2020,0.0,1.0
6073,Waste Land,291307,187716,103591,2010,0.644392342099572,0.3556076579004281
6074,Big Bad Wolves,291239,33232,258007,2014,0.11410559712126467,0.8858944028787353
6075,Imaginary Heroes,291118,228767,62351,2004,0.7858222439010986,0.21417775609890147
6076,Power and Terror: Noam Chomsky in Our Times,290767,290767,0,2002,1.0,0.0
6077,More Than Funny,290498,290498,0,2018,1.0,0.0
6078,Illégal,290108,651,289457,2010,0.0022439918926744525,0.9977560081073256
6079,Jimmy Vestvood: Amerikan Hero,290080,230069,60011,2016,0.7931225868725869,0.20687741312741312
6080,Best F(r)iends: Volume 1,290064,252410,37654,2018,0.8701872690164929,0.1298127309835071
6081,Scratch,289885,289885,0,2002,1.0,0.0
6082,The Zoya Factor,289631,128831,160800,2019,0.4448108109974416,0.5551891890025584
6083,Best Night Ever,289511,0,289511,2014,0.0,1.0
6084,The Silence of Others,289455,67986,221469,2018,0.2348758874436441,0.7651241125563559
6085,Welcome to New York,288837,0,288837,2014,0.0,1.0
6086,Antarctica: A Year on Ice,288757,288757,0,2014,1.0,0.0
6087,Above and Beyond,288751,288751,0,2015,1.0,0.0
6088,The Last of Robin Hood,288545,288545,0,2014,1.0,0.0
6089,Saga of Tanya the Evil - The Movie,288460,288460,0,2019,1.0,0.0
6090,Last Train Home,288328,288328,0,2010,1.0,0.0
6091,American Pimp,287724,287724,0,2000,1.0,0.0
6092,Countdown to Zero,287711,272040,15671,2010,0.9455321485796511,0.05446785142034889
6093,Generation Wealth,287709,237709,50000,2018,0.8262132919025821,0.17378670809741786
6094,Skate Kitchen,287307,236799,50508,2018,0.824201986028882,0.175798013971118
6095,Post Mortem,286702,9750,276952,2010,0.03400743629273601,0.9659925637072639
6096,The Interrupters,286457,282448,4009,2011,0.9860048803136248,0.013995119686375268
6097,Notre musique,285354,139922,145432,2004,0.4903453254553993,0.5096546745446008
6098,But Deliver Us from Evil,285169,285169,0,2018,1.0,0.0
6099,Das letzte Schweigen 2012 Re-release,284471,100214,184257,2012,0.35228195492686426,0.6477180450731358
6100,Khalid: Free Spirit,284229,284229,0,2019,1.0,0.0
6101,South of the Border,284214,198600,85614,2010,0.6987692372648778,0.3012307627351221
6102,The Anonymous People,284147,284147,0,2013,1.0,0.0
6103,The Kindergarten Teacher,284065,36190,247875,2014,0.12740041891820533,0.8725995810817947
6104,George Washington,283846,247406,36440,2000,0.8716205266235917,0.12837947337640834
6105,The Heart of Me,282519,196067,86452,2003,0.6939958020522513,0.30600419794774864
6106,Disney's Newsies: The Broadway Musical! 2018 Re-release,282429,282429,0,2018,1.0,0.0
6107,Tumbledown,282083,135026,147057,2016,0.47867471630690256,0.5213252836930974
6108,Ho Mann Jahaan,281926,208611,73315,2016,0.7399494902917787,0.2600505097082213
6109,Green Dragon,281803,281803,0,2002,1.0,0.0
6110,Mike Wallace Is Here,281245,281245,0,2019,1.0,0.0
6111,Zus & Zo,281219,49468,231751,2002,0.17590561092956022,0.8240943890704397
6112,"If I Want to Whistle, I Whistle",280892,12135,268757,2010,0.04320165757657748,0.9567983424234225
6113,The Body,280777,36849,243928,2001,0.13123938214312425,0.8687606178568757
6114,Octaman,280710,280710,0,2019,1.0,0.0
6115,I Do... Until I Don't,280668,280668,0,2017,1.0,0.0
6116,Who Is Cletis Tout?,280458,252706,27752,2002,0.9010475721854966,0.09895242781450342
6117,The Battle of Shaker Heights,280351,280351,0,2003,1.0,0.0
6118,The Black Power Mixtape 1967-1975,280025,273749,6276,2011,0.9775877153825552,0.02241228461744487
6119,Namaste England,279934,104156,175778,2018,0.37207341730550775,0.6279265826944923
6120,Wonders of the Sea,279415,100780,178635,2018,0.360682139469964,0.6393178605300359
6121,Havenhurst,279372,0,279372,2016,0.0,1.0
6122,Christmas in the Clouds,279225,279225,0,2005,1.0,0.0
6123,"Lovely, Still",279170,127564,151606,2010,0.4569402156392163,0.5430597843607837
6124,The Five Obstructions,279032,165845,113187,2004,0.5943583531637948,0.4056416468362052
6125,"Lou Andreas-Salomé, The Audacity to be Free",278982,12875,266107,2017,0.04614993081990953,0.9538500691800905
6126,Smiling Fish & Goat on Fire,278492,278492,0,2000,1.0,0.0
6127,10 Years,278336,203373,74963,2012,0.730674436652104,0.2693255633478961
6128,Bolshoi Ballet: The Golden Age,277666,171916,105750,2019,0.6191467446500472,0.38085325534995285
6129,The Summit,277651,243550,34101,2013,0.8771803451095079,0.12281965489049201
6130,Solas,277596,277596,0,2000,1.0,0.0
6131,Science Fair,277338,276195,1143,2018,0.9958786751184475,0.004121324881552474
6132,See You Soon,277126,0,277126,2019,0.0,1.0
6133,True Grit 2019 Re-release,276418,276418,0,2019,1.0,0.0
6134,Seven Samurai 2002 Re-release,275965,271841,4124,2002,0.9850560759516606,0.014943924048339463
6135,Piñero,275171,275171,0,2001,1.0,0.0
6136,Life After Beth,274717,88273,186444,2014,0.3213233982607556,0.6786766017392444
6137,Hey Ram,274675,274675,0,2000,1.0,0.0
6138,Lovely Molly,274480,18464,256016,2012,0.06726901777907315,0.9327309822209269
6139,The King,273601,259291,14310,2018,0.9476975595849431,0.05230244041505696
6140,A Man Apart,273364,213143,60221,2005,0.7797039844310151,0.22029601556898495
6141,P.S.,273023,180503,92520,2004,0.6611274508008482,0.3388725491991517
6142,Slayer: The Repentless Killogy,272874,268727,4147,2019,0.9848025095831776,0.015197490416822416
6143,Chavela,272842,148666,124176,2017,0.5448794540429992,0.45512054595700074
6144,Stander,272791,31651,241140,2003,0.11602655512828502,0.883973444871715
6145,Black Death,272445,22554,249891,2010,0.0827836811099488,0.9172163188900512
6146,One Child Nation,271841,270128,1713,2019,0.993698522297961,0.0063014777020390595
6147,Come Out and Play,271735,2638,269097,2013,0.009707987561410933,0.9902920124385891
6148,Aloft,270971,53086,217885,2015,0.19591026345992746,0.8040897365400725
6149,Rishtey,270929,119537,151392,2002,0.44121153512543876,0.5587884648745612
6150,Deep in the Woods,270890,56119,214771,2000,0.2071652700358079,0.7928347299641921
6151,Waking the Dead,270745,270745,0,2000,1.0,0.0
6152,The Canyons,270185,56825,213360,2013,0.21031885559894148,0.7896811444010585
6153,This Old Cub,270014,270014,0,2004,1.0,0.0
6154,Exposed,269915,0,269915,2016,0.0,1.0
6155,Stalker,269881,269881,0,2017,1.0,0.0
6156,Shirin Farhad Ki Toh Nikal Padi,269845,155758,114087,2012,0.5772128444106802,0.4227871555893198
6157,The Loneliest Planet,268933,129579,139354,2012,0.4818263284907393,0.5181736715092606
6158,The World Before Your Feet,268644,268644,0,2018,1.0,0.0
6159,Psycho Beach Party,268117,268117,0,2000,1.0,0.0
6160,Meri Pyaari Bindu,268067,0,268067,2017,0.0,1.0
6161,The Carer,267995,6208,261787,2016,0.023164611280061195,0.9768353887199388
6162,Conan O'Brien Can't Stop,267965,267965,0,2011,1.0,0.0
6163,Falcon Rising,267476,11774,255702,2014,0.04401890263051638,0.9559810973694837
6164,Gilles' Wife,267402,32799,234603,2004,0.12265802050844796,0.877341979491552
6165,Munger Road,266689,266689,0,2011,1.0,0.0
6166,Luzia: Cirque du Soleil in Cinema,265673,265673,0,2019,1.0,0.0
6167,Félicité,265495,12433,253062,2017,0.04682950714702725,0.9531704928529727
6168,Out of Liberty,265279,265279,0,2019,1.0,0.0
6169,Asbury Park: Riot Redemption Rock 'n Roll,264983,167684,97299,2019,0.6328104067053358,0.36718959329466416
6170,Doctor Who,264629,264629,0,2018,1.0,0.0
6171,Riding the Bullet,264505,134711,129794,2004,0.5092947203266479,0.4907052796733521
6172,Beautiful People,264292,264292,0,2000,1.0,0.0
6173,Phil Ochs: There But for Fortune,263723,263723,0,2011,1.0,0.0
6174,The Producers 2018 Re-release,263277,216807,46470,2018,0.8234938866668946,0.17650611333310542
6175,Life and Debt,263107,263107,0,2001,1.0,0.0
6176,My Date with Drew,262770,181041,81729,2005,0.6889713437607032,0.3110286562392967
6177,Raja,262643,13000,249643,2003,0.04949684552796001,0.95050315447204
6178,Grand départ,262412,677,261735,2013,0.0025799125040013413,0.9974200874959986
6179,Augustine,262390,107352,155038,2013,0.40913144555813863,0.5908685544418614
6180,The Final Year,262286,191900,70386,2018,0.73164408317638,0.26835591682362003
6181,Minimalism: A Documentary About the Important Things,261865,261865,0,2016,1.0,0.0
6182,Any Day Now,261747,201395,60352,2012,0.7694262016374591,0.23057379836254094
6183,Half Girlfriend,261597,0,261597,2017,0.0,1.0
6184,Circuit,261155,235087,26068,2002,0.9001818843215715,0.09981811567842852
6185,Eating You Alive,260534,260534,0,2018,1.0,0.0
6186,Stone Reader,260523,260523,0,2003,1.0,0.0
6187,Her Smell,260481,255599,4882,2019,0.9812577500854189,0.0187422499145811
6188,Star Raiders: The Adventures of Saber Raine,260234,260234,0,2019,1.0,0.0
6189,The Wind Will Carry Us,259510,259510,0,2000,1.0,0.0
6190,James' Journey to Jerusalem,259026,64967,194059,2004,0.25081265973299977,0.7491873402670002
6191,The Cave,258921,62625,196296,2019,0.24186914155282885,0.7581308584471711
6192,Malevolence,258782,127287,131495,2004,0.4918696045319999,0.5081303954680001
6193,The Unspoken,258760,0,258760,2016,0.0,1.0
6194,Across the Universe 2018 Re-release,258618,258618,0,2018,1.0,0.0
6195,What Time Is It There?,258592,195760,62832,2001,0.7570226457121644,0.24297735428783565
6196,Big 2018 Re-release,258507,258507,0,2018,1.0,0.0
6197,The Music Never Stopped,258223,258223,0,2011,1.0,0.0
6198,Mayor of the Sunset Strip,257315,257315,0,2004,1.0,0.0
6199,Mysteries of Lisbon,257065,110507,146558,2010,0.42987960243518175,0.5701203975648182
6200,Spiders,257019,0,257019,2013,0.0,1.0
6201,Raja Natwarlal,256978,131105,125873,2014,0.5101798597545315,0.4898201402454685
6202,Helicopter Eela,256952,71971,184981,2018,0.2800951150409415,0.7199048849590585
6203,Alive Inside: A Story of Music and Memory,256682,256682,0,2014,1.0,0.0
6204,Jean-Michel Basquiat: The Radiant Child,256242,256242,0,2010,1.0,0.0
6205,Greendale,255947,255947,0,2004,1.0,0.0
6206,Officer Down,255080,1463,253617,2013,0.005735455543358946,0.994264544456641
6207,Sex with Strangers,254852,254852,0,2002,1.0,0.0
6208,Gerry,254683,254683,0,2003,1.0,0.0
6209,Dean,254536,254536,0,2017,1.0,0.0
6210,The Robber,254489,83451,171038,2010,0.3279159413569938,0.6720840586430061
6211,Maelstrom,254380,254380,0,2000,1.0,0.0
6212,Civil Brand,254293,254293,0,2003,1.0,0.0
6213,Fall in Love Like a Star 2015 Re-release,253785,212508,41277,2015,0.8373544535729062,0.1626455464270938
6214,Battle in Heaven,253751,70899,182852,2005,0.27940382500955663,0.7205961749904434
6215,Mistaken for Strangers,253285,138991,114294,2014,0.5487533805791894,0.45124661942081057
6216,Battlefield America,252805,172000,80805,2012,0.6803662902236902,0.3196337097763098
6217,I Got the Hook Up 2,252293,252293,0,2019,1.0,0.0
6218,The Human Centipede (First Sequence),252207,181467,70740,2010,0.7195161117653356,0.28048388823466436
6219,Caterpillar,251922,4157,247765,2010,0.01650113924151126,0.9834988607584887
6220,Canal Street,251917,251917,0,2019,1.0,0.0
6221,Gook,251541,250130,1411,2017,0.994390576486537,0.005609423513463014
6222,Dominion,251495,251495,0,2005,1.0,0.0
6223,Happenstance,251444,251444,0,2001,1.0,0.0
6224,Games of Love and Chance 2005 Re-release,249616,8085,241531,2005,0.032389750657009164,0.9676102493429908
6225,Gay Sex in the 70s,249565,249565,0,2005,1.0,0.0
6226,Harry Potter and the Chamber of Secrets 2018 Re-release,249426,245501,3925,2018,0.9842638698451645,0.015736130154835503
6227,May,249300,150277,99023,2003,0.602795828319294,0.397204171680706
6228,Skins,249204,249204,0,2002,1.0,0.0
6229,The Twilight Zone: A 60th Anniversary Celebration,248514,248514,0,2019,1.0,0.0
6230,Band Aid,248370,248370,0,2017,1.0,0.0
6231,The Attacks of 26/11,248346,248346,0,2013,1.0,0.0
6232,Testosterone,248128,185078,63050,2004,0.7458972788238328,0.2541027211761671
6233,Wild Oats,247949,40598,207351,2016,0.16373528427216888,0.8362647157278311
6234,Doctor Who: The End of Time: Part One,247798,247798,0,2019,1.0,0.0
6235,Marcel Proust's Time Regained,247728,247728,0,2000,1.0,0.0
6236,Charlotte Sometimes,247554,150445,97109,2002,0.607725991096892,0.392274008903108
6237,Lilting,247377,27054,220323,2014,0.10936344122533623,0.8906365587746637
6238,The Galapagos Affair: Satan Came to Eden,247159,247159,0,2014,1.0,0.0
6239,My Dog Tulip,246574,246574,0,2010,1.0,0.0
6240,The Notebook 2013 Re-release,246557,66559,179998,2013,0.2699538037857372,0.7300461962142628
6241,The Animation Show 2005 Re-release,246520,246520,0,2005,1.0,0.0
6242,The Love Witch,246218,228894,17324,2016,0.9296395876824602,0.07036041231753974
6243,Hot Summer Nights,246133,0,246133,2018,0.0,1.0
6244,Watermarks,246094,246094,0,2005,1.0,0.0
6245,"Tuesday, After Christmas",245833,27813,218020,2010,0.1131377805258041,0.8868622194741959
6246,American Woman,245416,236637,8779,2019,0.9642280861883495,0.03577191381165042
6247,The Fireflies Are Gone,245006,245006,0,2018,1.0,0.0
6248,The Waiting Room,244951,244951,0,2012,1.0,0.0
6249,This Is Spinal Tap 2000 Re-release,244557,244557,0,2000,1.0,0.0
6250,Time and Tide,243978,10770,233208,2001,0.044143324398101466,0.9558566756018986
6251,Term Life,243793,21256,222537,2016,0.08718872157937266,0.9128112784206274
6252,My Uncle Rafael,243616,243616,0,2012,1.0,0.0
6253,Rangeelay,243246,148418,94828,2013,0.6101559737878526,0.38984402621214737
6254,Santitos,243000,243000,0,2000,1.0,0.0
6255,Out of Blue,242847,18779,224068,2019,0.07732852372069657,0.9226714762793035
6256,Audition,242759,131296,111463,2001,0.5408491549231954,0.4591508450768046
6257,My Perestroika,242707,242707,0,2011,1.0,0.0
6258,Tevar,242453,236002,6451,2015,0.9733927812813205,0.026607218718679496
6259,Play the Flute,241251,241251,0,2019,1.0,0.0
6260,Brotherhood,240887,8979,231908,2010,0.03727473877793322,0.9627252612220668
6261,Darshan,240819,66032,174787,2005,0.2741976339076236,0.7258023660923765
6262,Road to Ninja - Naruto the Movie 2014 Re-release,240687,43171,197516,2014,0.17936573225807792,0.820634267741922
6263,Boulevard,240450,126150,114300,2015,0.5246412975670618,0.47535870243293826
6264,Carter High,240214,240214,0,2015,1.0,0.0
6265,ABCD (Any Body Can Dance),240194,222098,18096,2013,0.9246608991065556,0.07533910089344446
6266,Of Horses and Men,239969,11894,228075,2013,0.04956473544499498,0.950435264555005
6267,Dark River,239182,7714,231468,2018,0.03225159083877549,0.9677484091612245
6268,Uncovered: The War on Iraq,238924,238924,0,2004,1.0,0.0
6269,Nina's Tragedies,238831,238831,0,2005,1.0,0.0
6270,311 Enlarged to Show Detail 3,238791,238791,0,2019,1.0,0.0
6271,La bûche,238754,238754,0,2000,1.0,0.0
6272,Crown Heights,238558,238558,0,2017,1.0,0.0
6273,The Independent,238431,238431,0,2001,1.0,0.0
6274,RWBY: Argus Limited,238379,238379,0,2018,1.0,0.0
6275,"Ram Dass, Fierce Grace",238260,238260,0,2002,1.0,0.0
6276,Red Obsession,238223,13199,225024,2013,0.05540606910331916,0.9445939308966809
6277,American Satan,237708,237708,0,2017,1.0,0.0
6278,Alien Intrusion: Unmasking a Deception,237411,237411,0,2018,1.0,0.0
6279,Shuddh Desi Romance,237249,0,237249,2013,0.0,1.0
6280,New York Doll,237136,219672,17464,2005,0.9263544969975035,0.07364550300249646
6281,Middle of Nowhere,236806,236806,0,2012,1.0,0.0
6282,Chopper,236185,236185,0,2001,1.0,0.0
6283,The Far Side of the Moon,235926,235926,0,2003,1.0,0.0
6284,Varda by Agnès,235699,160765,74934,2019,0.6820775650299746,0.3179224349700253
6285,India's Most Wanted,235351,176858,58493,2019,0.7514648333765312,0.24853516662346878
6286,The Exorcist Extended Director's Cut,235134,235134,0,2010,1.0,0.0
6287,Diamantino,235041,70088,164953,2018,0.29819478303785296,0.701805216962147
6288,Art and Craft,235037,235037,0,2014,1.0,0.0
6289,Blind Eyes Opened,234505,234505,0,2020,1.0,0.0
6290,After the Ball,234417,161820,72597,2015,0.6903082967532218,0.3096917032467782
6291,Swimming,234287,234287,0,2002,1.0,0.0
6292,Little Shop of Horrors 2017 Re-release,233865,233865,0,2017,1.0,0.0
6293,Superman 2018 Re-release,233585,233585,0,2018,1.0,0.0
6294,Premier Boxing Champions: PBC on FOX: Spence vs. Porter,232973,232973,0,2019,1.0,0.0
6295,Lost and Found in Armenia,232857,122305,110552,2012,0.5252365185500114,0.47476348144998864
6296,Down and Derby,231609,231609,0,2005,1.0,0.0
6297,Bishôjo senshi Sailor Moon Super S Special,231434,231434,0,2018,1.0,0.0
6298,The World,231383,64123,167260,2005,0.27712926187317133,0.7228707381268287
6299,A Place at the Table,231378,231378,0,2013,1.0,0.0
6300,The Great Role,231162,11419,219743,2004,0.04939825749906992,0.9506017425009301
6301,Les destinées,230900,230900,0,2002,1.0,0.0
6302,DAZN Boxing: Canelo Alvarez vs. Daniel Jacobs,230703,230703,0,2019,1.0,0.0
6303,"Life, Above All",230529,134461,96068,2011,0.5832715189845963,0.4167284810154037
6304,Chakravyuh,230136,151778,78358,2012,0.6595143741092224,0.34048562589077763
6305,"Belle and Sebastian, Friends for Life 2018 Re-release",229983,105890,124093,2018,0.4604253357856885,0.5395746642143114
6306,Wrecked,229532,8020,221512,2011,0.03494066186849764,0.9650593381315024
6307,Ophelia,229405,50722,178683,2019,0.22110241712255618,0.7788975828774438
6308,Luv Shuv Tey Chicken Khurana,229136,143507,85629,2012,0.6262961734515746,0.3737038265484254
6309,Dig!,228828,127067,101761,2004,0.5552948065796144,0.4447051934203856
6310,Fast Food Fast Women,228787,17131,211656,2001,0.07487750615201039,0.9251224938479896
6311,Murder 2,228501,59000,169501,2011,0.2582045592798281,0.7417954407201719
6312,City of Ghosts,228225,128015,100210,2017,0.560915762953226,0.439084237046774
6313,Jeremiah Tower: The Last Magnificent,228153,228153,0,2017,1.0,0.0
6314,InAPPropriate Comedy,228004,228004,0,2013,1.0,0.0
6315,Like Water,227332,0,227332,2012,0.0,1.0
6316,Guiana 1838,227241,227241,0,2004,1.0,0.0
6317,Studio 54,227062,199767,27295,2018,0.879790541790348,0.120209458209652
6318,This So-Called Disaster: Sam Shepard Directs the Late Henry Moss,226658,226658,0,2004,1.0,0.0
6319,Mine 9,226421,226421,0,2019,1.0,0.0
6320,The Agronomist,226189,226189,0,2004,1.0,0.0
6321,Blue Gate Crossing,226067,6242,219825,2003,0.02761128338059071,0.9723887166194093
6322,Rumble: The Indians Who Rocked The World,226006,226006,0,2017,1.0,0.0
6323,The Keeper: The Legend of Omar Khayyam,225863,225863,0,2005,1.0,0.0
6324,The Ballad of Ramblin' Jack,225682,225682,0,2000,1.0,0.0
6325,Dr. Cabbie,225490,225490,0,2014,1.0,0.0
6326,The Beauty Academy of Kabul,225448,225448,0,2005,1.0,0.0
6327,Murderous Maids,225390,225390,0,2002,1.0,0.0
6328,Millennium Actress 2019 Re-release,225250,225250,0,2019,1.0,0.0
6329,The Last Tree,224751,6203,218548,2019,0.027599432260590608,0.9724005677394094
6330,The Black Waters of Echo's Pond,224409,224409,0,2010,1.0,0.0
6331,Funny Girl 2001 Re-release,224263,223306,957,2001,0.9957326888519283,0.004267311148071684
6332,Experimenter,224145,155575,68570,2015,0.6940819558767762,0.3059180441232238
6333,Tampopo,224097,224097,0,2016,1.0,0.0
6334,Extra Ordinary,223898,164346,59552,2019,0.7340217420432519,0.2659782579567482
6335,Premier Boxing Champions: PBC on FOX PPV: Pacquiao vs. Thurman,223858,223858,0,2019,1.0,0.0
6336,Crystal Fairy & the Magical Cactus,223821,202370,21451,2013,0.9041600207308519,0.09583997926914811
6337,BuyBust,223720,178471,45249,2018,0.7977427141069193,0.20225728589308065
6338,Tim and Eric's Billion Dollar Movie,223580,201436,22144,2012,0.9009571518024868,0.09904284819751319
6339,Love Liza,223426,213137,10289,2002,0.9539489584918497,0.04605104150815035
6340,Take Every Wave: The Life of Laird Hamilton,223301,176076,47225,2017,0.7885141580198924,0.21148584198010756
6341,Never Surrender: A Galaxy Quest Documentary,222971,222971,0,2019,1.0,0.0
6342,Spirit of the Game,222565,222565,0,2016,1.0,0.0
6343,10.000 Km,222530,12423,210107,2014,0.055826180739675546,0.9441738192603244
6344,Secret Things,222396,105090,117306,2002,0.4725354772567852,0.5274645227432148
6345,Bus 174,222247,217201,5046,2003,0.9772955315482323,0.02270446845176763
6346,High School,221590,139034,82556,2012,0.627438061284354,0.372561938715646
6347,Neil Young Journeys,221082,215026,6056,2012,0.9726074488198949,0.02739255118010512
6348,Phantom Boy,221016,34362,186654,2015,0.15547290693886415,0.8445270930611358
6349,Little Pink House,220948,220948,0,2018,1.0,0.0
6350,Chance Pe Dance,220619,168643,51976,2010,0.7644083238524334,0.23559167614756663
6351,Fair,220524,220524,0,2000,1.0,0.0
6352,The Cockettes,220165,220165,0,2002,1.0,0.0
6353,Supermensch: The Legend of Shep Gordon,220065,213064,7001,2014,0.9681866721196011,0.03181332788039897
6354,Lower City,219814,130794,89020,2005,0.5950212452346074,0.4049787547653926
6355,Great Performances at the Met: Puccini: Turandot,219619,172627,46992,2018,0.7860294418971037,0.2139705581028964
6356,Brooklyn Castle,219407,219407,0,2012,1.0,0.0
6357,Fragments of Truth,219342,219342,0,2018,1.0,0.0
6358,Club Life,219229,4444,214785,2015,0.020271040783837905,0.9797289592161621
6359,The House I Live In,219159,210752,8407,2012,0.9616397227583626,0.03836027724163735
6360,California Typewriter,218563,218563,0,2017,1.0,0.0
6361,Dark Money,217932,217932,0,2018,1.0,0.0
6362,Getting Grace,217812,217812,0,2018,1.0,0.0
6363,Beautiful Creatures,217679,55835,161844,2001,0.25650154585421653,0.7434984541457834
6364,Jane's Journey,217615,27253,190362,2010,0.12523493325368196,0.874765066746318
6365,Complete Unknown,217473,191761,25712,2016,0.881769231122944,0.118230768877056
6366,Ratcatcher,217244,217244,0,2000,1.0,0.0
6367,Two Men Went to War,217151,150208,66943,2003,0.6917214288674701,0.3082785711325299
6368,Beijing Bicycle,215854,66131,149723,2001,0.306369119868059,0.6936308801319411
6369,The Karate Kid 2019 Re-release,215447,215447,0,2019,1.0,0.0
6370,The Treasure of the Sierra Madre,215295,215295,0,2018,1.0,0.0
6371,The Tribe,215034,150564,64470,2015,0.7001869471804458,0.2998130528195541
6372,Risk,214669,200219,14450,2017,0.9326870670660412,0.06731293293395879
6373,2001: A Space Odyssey 2013 Re-release,214618,214618,0,2013,1.0,0.0
6374,Hamlet 2019 Re-release,214578,214578,0,2019,1.0,0.0
6375,The Pervert's Guide to Ideology,214313,67966,146347,2013,0.31713428490105594,0.6828657150989441
6376,Ingrid Bergman: In Her Own Words,214014,138148,75866,2015,0.6455091722971394,0.35449082770286056
6377,Marjorie Prime,213858,180608,33250,2017,0.844523001243816,0.155476998756184
6378,The Château,213598,202272,11326,2002,0.9469751589434358,0.0530248410565642
6379,Thaandavam,213476,213476,0,2012,1.0,0.0
6380,The Wound,213043,30678,182365,2017,0.14399909877348704,0.856000901226513
6381,The Delicate Art of Parking,213008,213008,0,2004,1.0,0.0
6382,The Afflicted,212940,212940,0,2011,1.0,0.0
6383,Chocolate City,212662,212662,0,2015,1.0,0.0
6384,Young & Wild,212624,5514,207110,2012,0.025933102566032058,0.9740668974339679
6385,Big Sonia,212471,212471,0,2017,1.0,0.0
6386,Fatima,212228,50105,162123,2016,0.23609043104585634,0.7639095689541436
6387,Donnie Darko 2016 Re-release,212034,207971,4063,2016,0.9808379788147183,0.019162021185281607
6388,Somewhere Between,210975,210975,0,2012,1.0,0.0
6389,La soga,210625,210625,0,2010,1.0,0.0
6390,A Glimpse Inside the Mind of Charles Swan III,210565,45350,165215,2013,0.2153729252249899,0.7846270747750101
6391,Tigers Are Not Afraid 2019 Re-release,210138,175559,34579,2019,0.8354462305722906,0.1645537694277094
6392,Beware of Mr. Baker,210123,116476,93647,2012,0.5543229441803135,0.4456770558196866
6393,"Faith, Hope & Love",210091,210091,0,2019,1.0,0.0
6394,House,209765,209765,0,2010,1.0,0.0
6395,The Death of Louis XIV,209715,43635,166080,2016,0.2080680924111294,0.7919319075888707
6396,Rob the Mob,209613,208693,920,2014,0.99561095924394,0.004389040756059977
6397,SEED: The Untold Story,209580,207825,1755,2016,0.9916261093615804,0.008373890638419696
6398,Kathy Griffin: A Hell of a Story,208907,208907,0,2019,1.0,0.0
6399,Casablanca 2013 Re-release,208608,208608,0,2013,1.0,0.0
6400,Boys Life 3,208538,208538,0,2000,1.0,0.0
6401,Agent Mr. Chan,208351,208351,0,2018,1.0,0.0
6402,The Right Kind of Wrong,208105,2098,206007,2014,0.010081449268398164,0.9899185507316018
6403,The Dating Project,208100,208100,0,2018,1.0,0.0
6404,Batman 2019 Re-release,207901,159419,48482,2019,0.766802468482595,0.2331975315174049
6405,Under the Electric Sky,207584,207584,0,2014,1.0,0.0
6406,Heading Home: The Tale of Team Israel,207533,207533,0,2018,1.0,0.0
6407,Sweetgrass,207473,207473,0,2010,1.0,0.0
6408,Advanced Style,207231,87879,119352,2014,0.4240630021570132,0.5759369978429868
6409,Ek Thi Daayan,206279,112135,94144,2013,0.5436084138472651,0.4563915861527349
6410,The Desert Bride,205350,30110,175240,2017,0.14662770878987094,0.853372291210129
6411,The Tic Code,205003,205003,0,2000,1.0,0.0
6412,The Untold Story of Emmett Louis Till,204956,204956,0,2005,1.0,0.0
6413,Sicilian Ghost Story,204892,15285,189607,2017,0.07460027721921793,0.9253997227807821
6414,The Iron Orchard,204881,204881,0,2019,1.0,0.0
6415,Working Woman,204727,64048,140679,2019,0.3128458874501165,0.6871541125498835
6416,Hesburgh,204709,204709,0,2019,1.0,0.0
6417,Don't Call Me Son,204583,11678,192905,2016,0.05708196673232869,0.9429180332676713
6418,Pop Aye,204464,77976,126488,2017,0.3813678691603412,0.6186321308396588
6419,Touchback,204232,204232,0,2012,1.0,0.0
6420,Postmen in the Mountains,203975,203975,0,2003,1.0,0.0
6421,The Home Teachers,203917,203917,0,2004,1.0,0.0
6422,Bulandi,203548,203548,0,2000,1.0,0.0
6423,States of Grace,203144,203144,0,2005,1.0,0.0
6424,Charlie's Country,202966,42937,160029,2014,0.2115477469132761,0.7884522530867238
6425,Keep the Change,202788,202788,0,2018,1.0,0.0
6426,"Filth to Ashes, Flesh to Dust",202531,202531,0,2011,1.0,0.0
6427,The Bolshoi Ballet: Live From Moscow - Coppélia,202217,202217,0,2018,1.0,0.0
6428,"Hieronymus Bosch, Touched by the Devil",201907,172533,29374,2016,0.8545171787010851,0.14548282129891485
6429,The Bad Batch,201890,180851,21039,2017,0.8957897865174105,0.10421021348258953
6430,Blink of an Eye,201874,201874,0,2019,1.0,0.0
6431,Lightning in a Bottle,201711,201711,0,2004,1.0,0.0
6432,The Vertical Ray of the Sun,201247,110134,91113,2001,0.5472578473219477,0.45274215267805235
6433,The Snow Walker,201149,201149,0,2004,1.0,0.0
6434,Independent Lens: Imelda,200992,200992,0,2004,1.0,0.0
6435,Kikujiro,200920,200920,0,2000,1.0,0.0
6436,Zombi Child,200909,25878,175031,2019,0.12880458316949464,0.8711954168305054
6437,Legendary,200393,200393,0,2010,1.0,0.0
6438,Masculin Féminin,200380,200380,0,2005,1.0,0.0
6439,Gemini,200340,200340,0,2018,1.0,0.0
6440,White Girl,200242,200242,0,2016,1.0,0.0
6441,No Place on Earth,200238,200238,0,2013,1.0,0.0
6442,9/11,200229,170000,30229,2017,0.8490278630967543,0.1509721369032458
6443,Or (My Treasure),200175,29194,170981,2004,0.14584238791057824,0.8541576120894218
6444,Listen Up Philip,200126,200126,0,2014,1.0,0.0
6445,Cutie and the Boxer,200036,200036,0,2013,1.0,0.0
6446,Rebel Without a Cause 2018 Re-release,199963,199963,0,2018,1.0,0.0
6447,The Fallen Idol 2016 Re-release,199619,199619,0,2016,1.0,0.0
6448,October Baby,199442,199442,0,2011,1.0,0.0
6449,Come on My Brother,199227,199227,0,2000,1.0,0.0
6450,Ex Libris: New York Public Library,198239,158192,40047,2017,0.7979862690994204,0.2020137309005796
6451,A Summer's Tale,198126,198126,0,2014,1.0,0.0
6452,Whores' Glory,197932,31420,166512,2011,0.1587413859305216,0.8412586140694784
6453,Pusher,197857,0,197857,2012,0.0,1.0
6454,Madeline's Madeline,197309,185576,11733,2018,0.9405348970396687,0.05946510296033126
6455,Sky Blue,197221,74663,122558,2004,0.3785753038469534,0.6214246961530466
6456,Have It All -The Movie,197142,197142,0,2018,1.0,0.0
6457,Little Joe,196960,23862,173098,2019,0.1211515028432169,0.8788484971567831
6458,Japón,196702,21900,174802,2003,0.111335929477077,0.888664070522923
6459,Mom,195701,0,195701,2017,0.0,1.0
6460,Boom for Real: The Late Teenage Years of Jean-Michel Basquiat,195517,166616,28901,2018,0.8521816517233796,0.14781834827662044
6461,The Princess and the Pea,195358,0,195358,2005,0.0,1.0
6462,The Divine Order,195081,76277,118804,2017,0.3910016864789498,0.6089983135210503
6463,Free Angela and All Political Prisoners,195005,194102,903,2013,0.9953693495038589,0.004630650496141125
6464,Family,194601,194601,0,2019,1.0,0.0
6465,A Screaming Man,193981,9862,184119,2010,0.0508400307246586,0.9491599692753414
6466,Alila,193385,50961,142424,2003,0.2635209556066913,0.7364790443933087
6467,Harry Potter and the Goblet of Fire 2018 Re-release,193306,188716,4590,2018,0.9762552636752092,0.023744736324790745
6468,Mr. Klein,193028,193028,0,2019,1.0,0.0
6469,Client 9: The Rise and Fall of Eliot Spitzer,192870,189416,3454,2010,0.982091564266086,0.017908435733914034
6470,November,192186,192186,0,2005,1.0,0.0
6471,Claire's Camera,191980,83418,108562,2018,0.4345140118762371,0.5654859881237629
6472,Past Life,191678,180099,11579,2017,0.9395913980738531,0.06040860192614698
6473,Diamond Men,191221,191221,0,2001,1.0,0.0
6474,Chalo Dilli,191185,94300,96885,2011,0.4932395323900934,0.5067604676099067
6475,The Romantics,191019,106524,84495,2010,0.5576618032761139,0.4423381967238861
6476,Digimon Adventure tri. Part 1: Reunion,190581,190581,0,2016,1.0,0.0
6477,One Week,190441,190441,0,2001,1.0,0.0
6478,Code Black,190229,190229,0,2014,1.0,0.0
6479,The Divine Plan,190031,190031,0,2019,1.0,0.0
6480,Java Heat,189739,1061,188678,2013,0.0055918920200907565,0.9944081079799092
6481,Munna Michael,189105,99629,89476,2017,0.5268448745405991,0.47315512545940086
6482,Nick Saban: Gamechanger,189000,189000,0,2010,1.0,0.0
6483,Days of Being Wild,188630,146310,42320,2004,0.7756454434607433,0.22435455653925673
6484,Lost Boys of Sudan,188467,188467,0,2003,1.0,0.0
6485,Leap Year,188242,12979,175263,2010,0.06894848121035688,0.9310515187896431
6486,The Bolshoi Ballet: Live From Moscow - Don Quixote,187946,187946,0,2018,1.0,0.0
6487,Owaranai hito: Miyazaki Hayao,187320,187320,0,2018,1.0,0.0
6488,Calle 54,187308,187308,0,2000,1.0,0.0
6489,The Last Days on Mars,187191,24084,163107,2013,0.12866003173229482,0.8713399682677052
6490,Stoned,187160,38922,148238,2005,0.20796110279974353,0.7920388972002564
6491,The Big Tease,187152,187152,0,2000,1.0,0.0
6492,In the Fog,186838,11894,174944,2013,0.06365942688318223,0.9363405731168177
6493,Good for Nothing,186119,0,186119,2012,0.0,1.0
6494,Twiceland,186078,52874,133204,2018,0.28414965767043926,0.7158503423295607
6495,Salt of This Sea 2010 Re-release,186045,11662,174383,2010,0.06268375930554436,0.9373162406944556
6496,In the Basement,186036,3643,182393,2014,0.019582231396073877,0.9804177686039262
6497,Buñuel in the Labyrinth of the Turtles,185675,36205,149470,2019,0.19499124814864682,0.8050087518513531
6498,National Theatre Live: King Lear,185305,185305,0,2018,1.0,0.0
6499,The Duke of Burgundy,185147,64521,120626,2015,0.3484852576601295,0.6515147423398705
6500,Cobra Kai Premiere Event feat. The Karate Kid,185082,185082,0,2018,1.0,0.0
6501,Amigo,184705,184705,0,2011,1.0,0.0
6502,To Dust,184495,184495,0,2019,1.0,0.0
6503,Vatel,184301,51080,133221,2000,0.27715530572270364,0.7228446942772964
6504,Score,184025,101382,82643,2017,0.5509142779513653,0.4490857220486347
6505,The River and the Wall,183602,183602,0,2019,1.0,0.0
6506,The Hidden Fortress,183579,183579,0,2001,1.0,0.0
6507,"The Man Nobody Knew: In Search of My Father, CIA Spymaster William Colby",183342,183342,0,2011,1.0,0.0
6508,Lambert & Stamp,183320,183320,0,2015,1.0,0.0
6509,Burnt Money,183132,183132,0,2001,1.0,0.0
6510,Hellbent,183066,183066,0,2005,1.0,0.0
6511,Whose Streets?,182799,182799,0,2017,1.0,0.0
6512,The Masked Saint,182695,182695,0,2016,1.0,0.0
6513,I Am Not A Witch,182462,50868,131594,2017,0.2787868158849514,0.7212131841150486
6514,Shock and Awe,182415,77980,104435,2018,0.42748677466217144,0.5725132253378286
6515,The Baxter,181872,181872,0,2005,1.0,0.0
6516,Fida,181865,98297,83568,2004,0.5404943227119017,0.4595056772880983
6517,Fulltime Killer,181662,23124,158538,2001,0.12729134326386365,0.8727086567361363
6518,Giant Little Ones,181507,181507,0,2019,1.0,0.0
6519,Rafiki,181316,137968,43348,2019,0.7609256767190982,0.23907432328090186
6520,Winnebago Man,181039,181039,0,2010,1.0,0.0
6521,1001 Grams,181030,10983,170047,2014,0.06066950229243772,0.9393304977075623
6522,An Honest Liar,180590,180590,0,2015,1.0,0.0
6523,Fukrey,180331,125279,55052,2013,0.694716937187727,0.30528306281227297
6524,Go for It!,180237,180237,0,2011,1.0,0.0
6525,Lost Woods,180117,180117,0,2012,1.0,0.0
6526,Chop Suey,179914,179914,0,2001,1.0,0.0
6527,Lila & Eve,179807,38263,141544,2015,0.21280039153091926,0.7871996084690808
6528,Cherish,179751,179751,0,2002,1.0,0.0
6529,Protocols of Zion,178875,178875,0,2005,1.0,0.0
6530,Offender,178158,0,178158,2012,0.0,1.0
6531,Walking on Water,178119,102140,75979,2019,0.5734368596275524,0.42656314037244764
6532,Lagaan: Once Upon a Time in India 2002 Re-release,178072,73276,104796,2002,0.41149647333662787,0.5885035266633721
6533,Modest Heroes,178027,178027,0,2019,1.0,0.0
6534,Zaytoun,177753,42330,135423,2013,0.2381394406845454,0.7618605593154546
6535,Monumental: In Search of America's National Treasure,177729,177729,0,2012,1.0,0.0
6536,Nostalgia for the Light,177634,163962,13672,2010,0.9230327527387775,0.07696724726122252
6537,Bush's Brain,177485,177485,0,2004,1.0,0.0
6538,Tarkovsky At 70,177345,177345,0,2002,1.0,0.0
6539,People Places Things,177338,67046,110292,2015,0.3780689981842583,0.6219310018157417
6540,The Warrior Queen of Jhansi,177289,177289,0,2019,1.0,0.0
6541,Anita: Speaking Truth to Power,176979,176979,0,2014,1.0,0.0
6542,Bye Bye Germany,176933,73730,103203,2017,0.4167114105339309,0.5832885894660691
6543,Casino Jack and the United States of Money,176865,176865,0,2010,1.0,0.0
6544,Touch the Sound: A Sound Journey with Evelyn Glennie,176801,176801,0,2005,1.0,0.0
6545,Anchor Baby,176784,15790,160994,2010,0.08931803783147796,0.910681962168522
6546,Vigilante Diaries,176777,1991,174786,2016,0.01126277739751212,0.9887372226024879
6547,The Sea,176401,75994,100407,2003,0.430802546470825,0.5691974535291751
6548,"Iyengar: The Man, Yoga, and the Student's Journey",176387,176387,0,2019,1.0,0.0
6549,Better Watch Out,176288,20369,155919,2017,0.1155438827373389,0.884456117262661
6550,Girl on a Bicycle,176272,91401,84871,2013,0.5185225106653354,0.4814774893346646
6551,The Bolshoi Ballet: Live From Moscow - The Flames of Paris,175922,175922,0,2018,1.0,0.0
6552,Afternoon Delight,175755,174496,1259,2013,0.9928366191573497,0.00716338084265028
6553,The Business of Fancydancing,175710,175710,0,2002,1.0,0.0
6554,Butter,175706,105018,70688,2012,0.5976915984656187,0.4023084015343813
6555,A.C.O.D.,175705,175705,0,2013,1.0,0.0
6556,Black Rock,175682,0,175682,2013,0.0,1.0
6557,Champion,175232,175232,0,2017,1.0,0.0
6558,Cleopatra's Second Husband,175058,175058,0,2000,1.0,0.0
6559,Marooned in Iraq,174357,141243,33114,2003,0.8100793200158296,0.18992067998417042
6560,Stateside,174318,174318,0,2004,1.0,0.0
6561,Always at The Carlyle,174251,174251,0,2018,1.0,0.0
6562,SOMM,174197,174197,0,2013,1.0,0.0
6563,Grand Illusion,174065,174065,0,2012,1.0,0.0
6564,American Women,174011,164927,9084,2000,0.9477964036756297,0.0522035963243703
6565,Mercy Streets,173599,173599,0,2000,1.0,0.0
6566,Baptists at Our Barbecue,173306,173306,0,2004,1.0,0.0
6567,Neon Bull,173219,26734,146485,2016,0.15433641806037443,0.8456635819396255
6568,Cirkus Columbia,173083,3457,169626,2011,0.019973076500869526,0.9800269234991305
6569,Them That Follow,172952,159218,13734,2019,0.9205906841204496,0.0794093158795504
6570,Bellflower,172935,168226,4709,2011,0.9727701159395149,0.027229884060485154
6571,Rodin 2017 Re-release,172619,44261,128358,2017,0.256408622457551,0.743591377542449
6572,Forty Shades of Blue,172569,75828,96741,2005,0.43940684595726925,0.5605931540427307
6573,Afternoon of a Faun: Tanaquil Le Clercq,172450,172450,0,2014,1.0,0.0
6574,All Things Must Pass,172394,172394,0,2015,1.0,0.0
6575,Escape from Tomorrow,171962,171962,0,2013,1.0,0.0
6576,Little Woods,171912,150010,21902,2019,0.8725976080785518,0.12740239192144817
6577,Copperhead,171740,171740,0,2013,1.0,0.0
6578,Abuse of Weakness,171660,31611,140049,2014,0.1841488989863684,0.8158511010136316
6579,United Passions,171511,607,170904,2014,0.003539131600888573,0.9964608683991114
6580,North Station,171400,171400,0,2002,1.0,0.0
6581,The Bolshoi Ballet: Live From Moscow - La Sylphide,171177,171177,0,2018,1.0,0.0
6582,Palau the Movie,171155,134696,36459,2019,0.786982559668137,0.21301744033186293
6583,Cheerful Weather for the Wedding,170922,2651,168271,2012,0.015509998712863177,0.9844900012871368
6584,Uninvited Guest,170832,170832,0,2000,1.0,0.0
6585,Apparition Hill,170457,170457,0,2016,1.0,0.0
6586,The Human Centipede II (Full Sequence),170323,141877,28446,2011,0.8329879112040065,0.1670120887959935
6587,Knockout,169503,169503,0,2000,1.0,0.0
6588,The Fits,169236,166425,2811,2016,0.9833900588527263,0.01660994114727363
6589,Viva Riva!,168982,61759,107223,2011,0.3654767963451729,0.6345232036548272
6590,Free the Mind,168916,157201,11715,2013,0.930646001562907,0.06935399843709299
6591,Grizzly Falls,168874,168874,0,2000,1.0,0.0
6592,Britt-Marie Was Here,168862,36549,132313,2019,0.21644301263753835,0.7835569873624617
6593,Girls of the Sun,168771,19712,149059,2018,0.1167973170746159,0.8832026829253841
6594,Valley of Bones,168738,168738,0,2017,1.0,0.0
6595,Hangman's Curse,168406,168406,0,2003,1.0,0.0
6596,De Palma,168045,165237,2808,2016,0.9832901901276444,0.016709809872355617
6597,Twentynine Palms,167999,54523,113476,2003,0.32454359847380043,0.6754564015261996
6598,The Clovehitch Killer,167994,8208,159786,2018,0.04885888781742205,0.9511411121825779
6599,The Bolshoi Ballet: Live From Moscow - The Lady of the Camellias,167991,167991,0,2018,1.0,0.0
6600,Perrier's Bounty,167938,828,167110,2010,0.004930390977622694,0.9950696090223773
6601,Beauty and the Dogs,167723,8915,158808,2017,0.05315311555362115,0.9468468844463789
6602,Genius Within: The Inner Life of Glenn Gould,167508,167508,0,2010,1.0,0.0
6603,Ziggy Stardust and the Spiders from Mars,167239,162547,4692,2002,0.9719443431257063,0.028055656874293674
6604,On_Line,167102,167102,0,2003,1.0,0.0
6605,Is Genesis History? 2018 Re-release,166763,166763,0,2018,1.0,0.0
6606,We'll Meet Again,166484,91968,74516,2004,0.5524134451358689,0.44758655486413107
6607,The Day After,166022,24746,141276,2017,0.1490525352061775,0.8509474647938225
6608,Far From the Tree,166018,166018,0,2018,1.0,0.0
6609,Fool for Love,165987,165987,0,2010,1.0,0.0
6610,The Film Critic,165891,7358,158533,2014,0.04435442549625959,0.9556455745037404
6611,Bright Ones,165627,165627,0,2019,1.0,0.0
6612,Solomon & Gaenor,165485,165485,0,2000,1.0,0.0
6613,Maybe Baby,165046,20501,144545,2001,0.12421385553118525,0.8757861444688148
6614,Uncle Nino,165000,165000,0,2005,1.0,0.0
6615,Christmas Eve,164839,91302,73537,2015,0.5538859129210927,0.4461140870789073
6616,Nas: Time Is Illmatic,164540,164540,0,2014,1.0,0.0
6617,The Chambermaid,164531,86422,78109,2019,0.525262716448572,0.474737283551428
6618,Red Betsy,164520,164520,0,2003,1.0,0.0
6619,Hybrid,164386,164386,0,2002,1.0,0.0
6620,Eastern Boys,164290,16831,147459,2014,0.10244689268975592,0.8975531073102441
6621,Lost & Found,164026,125173,38853,2018,0.7631290161315889,0.2368709838684111
6622,Keep on Keepin' On,163745,163745,0,2014,1.0,0.0
6623,Narco Cultura,163690,145088,18602,2013,0.88635836031523,0.11364163968477
6624,Halston,163446,151991,11455,2019,0.9299156908091969,0.07008430919080308
6625,Stolen Summer,163348,134736,28612,2002,0.8248402184293655,0.17515978157063447
6626,The Fassbinder Series,162885,162885,0,2003,1.0,0.0
6627,Face,162717,108151,54566,2004,0.6646570425954265,0.3353429574045736
6628,Walking Out,162445,101947,60498,2017,0.6275785650527871,0.3724214349472129
6629,The Turin Horse,162088,56391,105697,2011,0.34790360791668723,0.6520963920833127
6630,Torremolinos 73 2005 Re-release,161651,87385,74266,2005,0.5405781591205746,0.45942184087942545
6631,Road to Nowhere,161619,40294,121325,2011,0.24931474640976617,0.7506852535902339
6632,The Samuel Project,161565,161565,0,2018,1.0,0.0
6633,Mughal-E-Azam,161434,161434,0,2005,1.0,0.0
6634,Lu Over the Wall,161253,109857,51396,2018,0.6812710461200722,0.31872895387992783
6635,Tharlo,161229,17091,144138,2016,0.10600450291200715,0.8939954970879929
6636,Spring Fever,161110,10824,150286,2010,0.06718391161318354,0.9328160883868165
6637,Bulgarian Lovers,161027,60712,100315,2003,0.3770299390785396,0.6229700609214603
6638,"Diana Ross: Her Life, Love and Legacy",160968,160968,0,2019,1.0,0.0
6639,Gigantic (A Tale of Two Johns),160621,160621,0,2003,1.0,0.0
6640,National Theatre Live: The Curious Incident of the Dog in the Night-Time 2018 Re-release,160381,160381,0,2018,1.0,0.0
6641,Washington Heights,160291,160291,0,2003,1.0,0.0
6642,Danny Deckchair 2004 Re-release,160276,160276,0,2004,1.0,0.0
6643,Beauty and the Beast 2016 Re-release,160215,160215,0,2016,1.0,0.0
6644,Punks,160083,160083,0,2001,1.0,0.0
6645,Sinbad: The Fifth Voyage,159862,159862,0,2014,1.0,0.0
6646,The Eclipse,159852,133411,26441,2010,0.8345907464404574,0.16540925355954259
6647,Murder 3,159798,0,159798,2013,0.0,1.0
6648,The Model,159743,0,159743,2016,0.0,1.0
6649,Eames: The Architect & The Painter,159715,153088,6627,2011,0.9585073412015152,0.0414926587984848
6650,When Will I Be Loved,159429,159429,0,2004,1.0,0.0
6651,Km. 0 - Kilometer Zero,159338,159338,0,2003,1.0,0.0
6652,The Witness,159305,159305,0,2016,1.0,0.0
6653,We Are What We Are,159047,81381,77666,2013,0.5116789376725119,0.4883210623274881
6654,Until Forever,158872,35839,123033,2016,0.2255841180321265,0.7744158819678735
6655,The Last Resort,158646,158646,0,2018,1.0,0.0
6656,The Big Picture 2012 Re-release,158411,158411,0,2012,1.0,0.0
6657,Dev,158357,84728,73629,2004,0.535044235493221,0.464955764506779
6658,Mother of George,157937,157937,0,2013,1.0,0.0
6659,The Look of Silence,157857,109089,48768,2015,0.6910621638571619,0.30893783614283815
6660,Crazy Horse,157782,157782,0,2012,1.0,0.0
6661,Hell and Back,157768,157768,0,2015,1.0,0.0
6662,Till Human Voices Wake Us,157720,120601,37119,2002,0.7646525488206949,0.23534745117930508
6663,House of Fools,157613,57862,99751,2003,0.3671143877725822,0.6328856122274178
6664,Chasing Madoff,157612,157612,0,2011,1.0,0.0
6665,Eva Hesse,157481,157481,0,2016,1.0,0.0
6666,Suntan,157267,6643,150624,2016,0.042240266553059444,0.9577597334469405
6667,Derrida,157200,157200,0,2002,1.0,0.0
6668,LUV,156996,156996,0,2013,1.0,0.0
6669,One Day in September,156818,156818,0,2000,1.0,0.0
6670,Marina Abramovic: The Artist Is Present,156695,86637,70058,2012,0.5529021347203166,0.4470978652796835
6671,Jodi No. 1,156415,82834,73581,2001,0.5295783652462999,0.4704216347537001
6672,Hatchet II,156190,52604,103586,2010,0.3367949292528331,0.663205070747167
6673,Deadtime,156072,156072,0,2012,1.0,0.0
6674,Pépé le Moko,155895,155895,0,2002,1.0,0.0
6675,Queen & Country,155881,41297,114584,2015,0.26492645030504036,0.7350735496949596
6676,Matando Cabos 2005 Re-release,155874,155874,0,2005,1.0,0.0
6677,Money,155732,155732,0,2019,1.0,0.0
6678,Dans l'oeil du chat,155714,155714,0,2004,1.0,0.0
6679,Naqoyqatsi,155640,133058,22582,2002,0.8549087638139296,0.14509123618607042
6680,Duck Season 2005 Re-release,155410,147551,7859,2005,0.9494305385753813,0.05056946142461875
6681,The Forgiveness of Blood,155383,126700,28683,2012,0.8154045165816081,0.18459548341839196
6682,The Gleaners & I,155320,155320,0,2001,1.0,0.0
6683,Western,155215,41072,114143,2018,0.2646136004896434,0.7353863995103566
6684,The Boy and the World 2015 Re-release,155215,129480,25735,2015,0.8341977257352704,0.16580227426472957
6685,Eating Out,155212,155212,0,2005,1.0,0.0
6686,Magic Trip: Ken Kesey's Search for a Kool Place,155005,154521,484,2011,0.9968775200799974,0.0031224799200025807
6687,Pantaleón y las visitadoras,154976,43214,111762,2002,0.2788431757175305,0.7211568242824695
6688,Hansel & Gretel,154642,154642,0,2002,1.0,0.0
6689,Bad Reputation,154190,148568,5622,2018,0.963538491471561,0.03646150852843894
6690,Burden,154104,139270,14834,2020,0.9037403312049006,0.09625966879509941
6691,Eating Animals,153993,149614,4379,2018,0.9715636425032307,0.028436357496769333
6692,Suddenly,153985,44806,109179,2003,0.29097639380459134,0.7090236061954086
6693,Citizen Koch,153908,153908,0,2014,1.0,0.0
6694,The Tag Along: Devil Fish,153895,20726,133169,2018,0.13467624029370676,0.8653237597062933
6695,The Revolution Will Not Be Televised,153859,153859,0,2003,1.0,0.0
6696,The Terrorist,153629,153629,0,2000,1.0,0.0
6697,Harmonium,153283,17191,136092,2017,0.11215203251502123,0.8878479674849787
6698,Backstreet Boys: Show 'Em What You're Made Of,153068,153068,0,2015,1.0,0.0
6699,Quai des Orfèvres,152961,152961,0,2002,1.0,0.0
6700,In the Shadow of Women,152802,50291,102511,2015,0.329125273229408,0.670874726770592
6701,Deceptive Practice: The Mysteries and Mentors of Ricky Jay,152791,152791,0,2013,1.0,0.0
6702,Finding Fela,152346,120980,31366,2014,0.7941133997610702,0.2058866002389298
6703,The Call Up,152294,0,152294,2016,0.0,1.0
6704,Snake & Mongoose,152200,152200,0,2013,1.0,0.0
6705,One Week and a Day,152178,41614,110564,2016,0.2734560843223068,0.7265439156776933
6706,"Buttons, A New Musical Film",151983,151983,0,2018,1.0,0.0
6707,Born to Be Blue,151926,151926,0,2016,1.0,0.0
6708,The Boys & Girl from County Clare,151869,142872,8997,2004,0.9407581534085298,0.05924184659147028
6709,Lupin the 3rd: Castle of Cagliostro 2017 Re-release,151802,142425,9377,2017,0.9382287453393235,0.06177125466067641
6710,Go Tigers!,151779,151779,0,2001,1.0,0.0
6711,Dandelion,151755,0,151755,2005,0.0,1.0
6712,Generation Found,151751,151751,0,2016,1.0,0.0
6713,Garçon stupide,151702,151702,0,2005,1.0,0.0
6714,Red Riding: The Year of Our Lord 1974,151644,151644,0,2010,1.0,0.0
6715,Before You Know It,151507,151507,0,2019,1.0,0.0
6716,Jay Myself,151331,151331,0,2019,1.0,0.0
6717,Revenge of the Electric Car,151272,150886,386,2011,0.9974483050399281,0.0025516949600719236
6718,The Cremaster Cycle 2010 Re-release,151239,151239,0,2010,1.0,0.0
6719,Vampire Hunter D: Bloodlust,151086,151086,0,2001,1.0,0.0
6720,Glory 2019 Re-release,150801,150801,0,2019,1.0,0.0
6721,Tasting Menu,150718,18686,132032,2013,0.12397988296023037,0.8760201170397697
6722,Stoked: The Rise and Fall of Gator,150268,150268,0,2003,1.0,0.0
6723,Godzilla 2014 Re-release,150191,150191,0,2014,1.0,0.0
6724,Kicks,150191,150191,0,2016,1.0,0.0
6725,Nobody Else But You,150173,43040,107133,2011,0.28660278478821094,0.7133972152117891
6726,Invincible,150143,81954,68189,2002,0.5458396328833179,0.4541603671166821
6727,Only the Brave,150000,150000,0,2010,1.0,0.0
6728,The Day I Became a Woman,149971,149971,0,2001,1.0,0.0
6729,Piercing,149211,15856,133355,2019,0.10626562384810771,0.8937343761518923
6730,Michael Moore in TrumpLand,149090,149090,0,2016,1.0,0.0
6731,Gun Hill Road,148994,148994,0,2011,1.0,0.0
6732,From Afar,148630,30169,118461,2016,0.2029805557424477,0.7970194442575523
6733,The Kingmaker,148611,122587,26024,2019,0.8248851027178338,0.1751148972821662
6734,Trial by Fire,148504,148504,0,2019,1.0,0.0
6735,War and Peace,148503,148503,0,2019,1.0,0.0
6736,Bartleby,148479,148479,0,2002,1.0,0.0
6737,Tokyo Godfathers,148355,129560,18795,2003,0.8733106400188736,0.12668935998112635
6738,Harry Potter and the Deathly Hallows: Part 1 2018 Re-release,148263,148263,0,2018,1.0,0.0
6739,Girls Will Be Girls,148047,148047,0,2003,1.0,0.0
6740,Restless Creature: Wendy Whelan,147780,147780,0,2017,1.0,0.0
6741,Night of the Living Dead 2018 Re-release,147423,147423,0,2018,1.0,0.0
6742,The Strange Case of Angelica,147173,50135,97038,2010,0.3406535166097042,0.6593464833902958
6743,Driven,147172,0,147172,2019,0.0,1.0
6744,Songs My Brothers Taught Me,146937,34793,112144,2015,0.23678855563949175,0.7632114443605083
6745,Ayurveda: Art of Being,146713,32267,114446,2001,0.21993279395827228,0.7800672060417277
6746,American Promise,146702,146702,0,2013,1.0,0.0
6747,Watermark,146572,84464,62108,2014,0.576262860573643,0.423737139426357
6748,Dirty Deeds,146490,146490,0,2005,1.0,0.0
6749,Touched with Fire,146487,146487,0,2016,1.0,0.0
6750,5 Broken Cameras,146475,109983,36492,2012,0.7508653353814644,0.2491346646185356
6751,Biggie and Tupac,146419,94874,51545,2002,0.6479623546124479,0.35203764538755217
6752,Hannah,146325,11700,134625,2018,0.07995899538698104,0.920041004613019
6753,Starlet,146222,88212,58010,2012,0.6032744730615092,0.3967255269384908
6754,Company Man,146193,146193,0,2001,1.0,0.0
6755,Deadly Renovations,146146,146146,0,2012,1.0,0.0
6756,The Punk Singer,146000,122742,23258,2013,0.8406986301369863,0.1593013698630137
6757,Citizen K,145941,120411,25530,2019,0.8250662939132938,0.17493370608670628
6758,Framing John DeLorean,145625,145625,0,2019,1.0,0.0
6759,The Last Dalai Lama?,145524,145524,0,2017,1.0,0.0
6760,Deterrence,145071,145071,0,2000,1.0,0.0
6761,Krisha,144822,144822,0,2016,1.0,0.0
6762,Mr. Smith Goes to Washington 2018 Re-release,144738,144738,0,2018,1.0,0.0
6763,Irving Berlin's Holiday Inn The Broadway Musical,144550,144550,0,2017,1.0,0.0
6764,The Price of Everything,144446,87400,57046,2018,0.6050704069340792,0.39492959306592085
6765,Yellow Day 2015 Re-release,144163,144163,0,2015,1.0,0.0
6766,From Beneath,144123,144123,0,2012,1.0,0.0
6767,Cold Weather,144056,141358,2698,2011,0.9812711723218748,0.018728827678125174
6768,Dahmer,144008,144008,0,2002,1.0,0.0
6769,Thunder Soul,143986,143986,0,2011,1.0,0.0
6770,Cop Car,143658,134552,9106,2015,0.9366133455846525,0.06338665441534756
6771,Undertow,143597,143597,0,2004,1.0,0.0
6772,Dirty Girl,143485,55125,88360,2011,0.38418650033104507,0.6158134996689549
6773,X,143355,143355,0,2000,1.0,0.0
6774,Doctor Who: Logopolis,143248,143248,0,2019,1.0,0.0
6775,Alps,143234,16057,127177,2012,0.1121032715695994,0.8878967284304006
6776,Survival of the Dead,143191,101740,41451,2010,0.7105195158913619,0.28948048410863814
6777,Kids for Cash,143178,143178,0,2014,1.0,0.0
6778,Clash,143121,18215,124906,2016,0.12726993243479293,0.8727300675652071
6779,The Lost Skeleton of Cadavra,143121,143121,0,2004,1.0,0.0
6780,Disguising,143108,0,143108,2018,0.0,1.0
6781,Dragon 2012 Re-release,142029,11137,130892,2012,0.0784135634271874,0.9215864365728126
6782,John Dies at the End,141951,141951,0,2013,1.0,0.0
6783,Citadel,141886,13377,128509,2012,0.09427991486122662,0.9057200851387733
6784,May in the Summer,141605,22004,119601,2014,0.15538999329119735,0.8446100067088027
6785,Best F(r)iends Volume Two,141524,141524,0,2018,1.0,0.0
6786,Music from the Inside Out,141504,141504,0,2005,1.0,0.0
6787,Branagh Theatre Live: The Winter's Tale,141143,141143,0,2019,1.0,0.0
6788,Zu Warriors,141084,0,141084,2003,0.0,1.0
6789,Metropolis Giorgio Moroder Presents,140907,27362,113545,2011,0.19418481693599324,0.8058151830640068
6790,Canelo vs. Kovalev,140820,140820,0,2019,1.0,0.0
6791,Gore Vidal: The United States of Amnesia,140164,140164,0,2014,1.0,0.0
6792,Beautiful Boy,140123,77247,62876,2011,0.5512799469037917,0.4487200530962083
6793,The Weathered Underground,140091,140091,0,2010,1.0,0.0
6794,Liv & Ingmar,140041,10347,129694,2012,0.07388550495926192,0.9261144950407381
6795,The Wizard of Oz 2002 Re-release,139905,139905,0,2002,1.0,0.0
6796,Coherence,139745,102617,37128,2014,0.7343160757093277,0.2656839242906723
6797,Tigerland,139692,139692,0,2000,1.0,0.0
6798,Hunky Dory,139653,20296,119357,2012,0.14533164343050275,0.8546683565694972
6799,Support the Girls,139550,129124,10426,2018,0.9252884270870656,0.07471157291293443
6800,Flowers,139421,61568,77853,2014,0.44159775069752766,0.5584022493024724
6801,Wilder vs. Ortiz,139207,139207,0,2019,1.0,0.0
6802,Rock on 2,139173,98868,40305,2016,0.710396413097368,0.289603586902632
6803,Kamikaze Girls 2005 Re-release,139139,34424,104715,2005,0.24740726899000282,0.7525927310099972
6804,The Polar Express 2014 IMAX Release,139055,139055,0,2014,1.0,0.0
6805,Who Will Write Our History,138868,138039,829,2019,0.9940303021574445,0.0059696978425555205
6806,Head Full of Honey,138844,12350,126494,2018,0.0889487482354297,0.9110512517645704
6807,Good Ol' Freda,138811,138811,0,2013,1.0,0.0
6808,Zero Motivation,138609,116044,22565,2014,0.8372039333665202,0.16279606663347979
6809,The Brawler,138515,75929,62586,2018,0.548164458722882,0.451835541277118
6810,Beauty and the Beast 2002 Re-release,138503,138503,0,2002,1.0,0.0
6811,Fear and Trembling 2004 Re-release,138436,126684,11752,2004,0.915108786731775,0.08489121326822503
6812,Psycho-Pass: The Movie,138366,138366,0,2016,1.0,0.0
6813,Brooklyn Lobster,138267,138267,0,2005,1.0,0.0
6814,Lynryd Skynyrd: Last of the Street Survivors Farewell Tour,137888,137888,0,2019,1.0,0.0
6815,Love Ranch,137885,137885,0,2010,1.0,0.0
6816,Super Sucker,137628,137628,0,2003,1.0,0.0
6817,Time of Favor,137340,137340,0,2002,1.0,0.0
6818,Is the Man Who Is Tall Happy?,137042,137042,0,2013,1.0,0.0
6819,Slaughter Creek,136815,136815,0,2012,1.0,0.0
6820,Road,136700,136700,0,2002,1.0,0.0
6821,Harry Potter and the Order of the Phoenix 2018 Re-release,136574,132522,4052,2018,0.9703311025524624,0.0296688974475376
6822,Swiri,135892,98452,37440,2001,0.7244870926912548,0.27551290730874517
6823,I Will Follow,135809,135809,0,2011,1.0,0.0
6824,Mantra: Sounds Into Silence,135684,115013,20671,2018,0.8476533710680699,0.15234662893193007
6825,Sonchiriya,135413,86765,48648,2019,0.6407435032087022,0.35925649679129773
6826,La Sapienza,135392,135392,0,2015,1.0,0.0
6827,The Kind Words,135382,135382,0,2016,1.0,0.0
6828,The Ninth Day,135311,72888,62423,2005,0.5386701746347303,0.4613298253652696
6829,The Cherry Orchard,135280,135280,0,2002,1.0,0.0
6830,The Other Dream Team,135228,135228,0,2012,1.0,0.0
6831,The Other Story,135191,135191,0,2019,1.0,0.0
6832,The Bolshoi Ballet: Live From Moscow - A Hero of Our Time,135168,104837,30331,2017,0.7756051728219697,0.2243948271780303
6833,Harry Potter and the Half-Blood Prince 2018 Re-release,134880,130081,4799,2018,0.9644202253855279,0.03557977461447212
6834,My Neighbor Totoro 2015 Re-release,134877,0,134877,2015,0.0,1.0
6835,Another Day of Life,134801,3190,131611,2018,0.023664512874533573,0.9763354871254665
6836,Led Zeppelin: Celebration Day,134753,0,134753,2012,0.0,1.0
6837,Concert for George,134600,134600,0,2003,1.0,0.0
6838,Attenberg,134503,24036,110467,2010,0.17870233377694178,0.8212976662230582
6839,Made in Abyss: Journey's Dawn,134194,134047,147,2019,0.9989045709942322,0.001095429005767769
6840,Ism,134165,134165,0,2016,1.0,0.0
6841,Redwood Highway,134049,134049,0,2014,1.0,0.0
6842,Lunacy,133982,48324,85658,2005,0.36067531459449775,0.6393246854055022
6843,Be Natural: The Untold Story of Alice Guy-Blaché,133951,115685,18266,2019,0.8636367029734754,0.13636329702652464
6844,The Great Museum,133905,18020,115885,2014,0.13457301818453382,0.8654269818154662
6845,Pure Country 2: The Gift,133771,133771,0,2010,1.0,0.0
6846,Don't Think I've Forgotten: Cambodia's Lost Rock and Roll,133443,133443,0,2015,1.0,0.0
6847,Under the Shadow,133324,31900,101424,2016,0.23926674867240708,0.760733251327593
6848,The Jewish Cardinal,133232,133232,0,2014,1.0,0.0
6849,A Shot at Glory,133122,133122,0,2002,1.0,0.0
6850,"Hare Krishna! The Mantra, the Movement and the Swami Who Started It",133006,133006,0,2017,1.0,0.0
6851,Crying Ladies,132920,132920,0,2004,1.0,0.0
6852,Tonight You're Mine,132787,6255,126532,2011,0.04710551484708594,0.9528944851529141
6853,Hukkle,132745,53715,79030,2003,0.40464800934121814,0.5953519906587819
6854,1+1=11,132498,132498,0,2003,1.0,0.0
6855,Dawson City: Frozen Time,132369,132369,0,2016,1.0,0.0
6856,Sonny,132221,30005,102216,2002,0.22693066910702536,0.7730693308929747
6857,Kumaré,132160,132160,0,2012,1.0,0.0
6858,My Brother the Devil,132056,44906,87150,2012,0.34005270491306716,0.6599472950869328
6859,How to Survive a Plague,132055,132055,0,2012,1.0,0.0
6860,A Ballerina's Tale,131995,131995,0,2015,1.0,0.0
6861,Mugamoodi,131965,101000,30965,2012,0.7653544500435722,0.23464554995642783
6862,Touchez Pas au Grisbi,131548,131548,0,2003,1.0,0.0
6863,Robot Stories,131451,131451,0,2004,1.0,0.0
6864,28 Hotel Rooms,131208,18869,112339,2012,0.1438098286689836,0.8561901713310164
6865,Rudy 2018 Re-release,131200,131200,0,2018,1.0,0.0
6866,Son frère,131195,22834,108361,2003,0.1740462670071268,0.8259537329928732
6867,The Wind,130974,28252,102722,2019,0.21570693420068104,0.7842930657993189
6868,Mister America,130897,130897,0,2019,1.0,0.0
6869,The Image Book,130802,94153,36649,2018,0.7198131527040871,0.2801868472959129
6870,Saheb Biwi Aur Gangster 3,130403,0,130403,2018,0.0,1.0
6871,October,130335,32127,98208,2010,0.24649556911036943,0.7535044308896306
6872,Five Seasons: The Gardens of Piet Oudolf,130319,119223,11096,2018,0.9148550863649967,0.08514491363500334
6873,Requiem for the American Dream,130152,130152,0,2016,1.0,0.0
6874,Be Here to Love Me: A Film About Townes Van Zandt,129988,129988,0,2005,1.0,0.0
6875,Section 375,129916,0,129916,2019,0.0,1.0
6876,The Fairy,129818,38399,91419,2011,0.2957910305196506,0.7042089694803494
6877,Great Performances at the Met: Puccini: Madama Butterfly,129730,129730,0,2018,1.0,0.0
6878,Great Performances at the Met: Tchaikovsky: Eugene Onegin 2018 Re-release,129498,129498,0,2018,1.0,0.0
6879,Great Performances at the Met: Verdi: Il Trovatore,129393,129393,0,2018,1.0,0.0
6880,Whatever the Heart Says,129319,129319,0,2005,1.0,0.0
6881,Maryam,129265,129265,0,2002,1.0,0.0
6882,I Called Him Morgan,128986,128986,0,2017,1.0,0.0
6883,The Golden Era 2014 Re-release,128926,102931,25995,2014,0.7983727099266246,0.20162729007337543
6884,Yossi,128668,117047,11621,2012,0.9096822830851494,0.09031771691485062
6885,Love After Love,128602,121098,7504,2018,0.9416494300244164,0.058350569975583584
6886,The Adventurer: The Curse of the Midas Box,128471,6399,122072,2014,0.04980890629013552,0.9501910937098644
6887,Where Hands Touch,128269,67743,60526,2018,0.5281322844958641,0.47186771550413587
6888,Stonewall Uprising,128203,128203,0,2010,1.0,0.0
6889,Computer Chess,127852,102041,25811,2013,0.7981181365954385,0.20188186340456152
6890,Steve Jobs: The Lost Interview,127541,105710,21831,2011,0.8288315130036615,0.17116848699633844
6891,American Chai,127518,127518,0,2002,1.0,0.0
6892,Benda Bilili!,127362,13420,113942,2010,0.10536894835194172,0.8946310516480583
6893,Sleepless in Seattle 2018 Re-release,127281,127281,0,2018,1.0,0.0
6894,A Band Called Death,127257,127257,0,2013,1.0,0.0
6895,Friends and Family,127212,127212,0,2003,1.0,0.0
6896,O Fantasma,126783,126783,0,2002,1.0,0.0
6897,Chimes at Midnight,126724,126724,0,2016,1.0,0.0
6898,Silent Night,126594,14567,112027,2012,0.11506864464350601,0.884931355356494
6899,Escape Fire: The Fight to Rescue American Healthcare,126238,126238,0,2012,1.0,0.0
6900,The Arbor,126182,21620,104562,2010,0.17133981074955223,0.8286601892504478
6901,Baran,125900,125900,0,2001,1.0,0.0
6902,The Great Buster,125807,118344,7463,2018,0.9406789765275382,0.059321023472461785
6903,Europa Report,125687,125687,0,2013,1.0,0.0
6904,Paris Is Burning 2019 Re-release,125677,125677,0,2019,1.0,0.0
6905,Green Card Fever,125596,125596,0,2003,1.0,0.0
6906,This Changes Everything,125348,64988,60360,2019,0.5184606056738041,0.48153939432619586
6907,The B-Side: Elsa Dorfman's Portrait Photography,125227,125227,0,2017,1.0,0.0
6908,Spinning Plates,124856,112449,12407,2013,0.9006295252130454,0.09937047478695457
6909,Mary Magdalene 2019 Re-release,124741,124741,0,2019,1.0,0.0
6910,Every Secret Thing,124733,103536,21197,2015,0.8300610103180394,0.16993898968196067
6911,Hymn: Sarah Brightman In Concert,124707,113274,11433,2018,0.9083211046693449,0.09167889533065506
6912,Ran 2010 Re-release,124673,124673,0,2010,1.0,0.0
6913,A Tuba to Cuba,124592,121772,2820,2019,0.9773661230255554,0.022633876974444588
6914,'85: The Greatest Team in Football History,124573,124573,0,2018,1.0,0.0
6915,Final: The Rapture,124561,124561,0,2013,1.0,0.0
6916,Vidal Sassoon: The Movie,124532,85974,38558,2011,0.6903767706292359,0.30962322937076414
6917,Singin' in the Rain 2002 Re-release,124382,120420,3962,2002,0.9681465163769677,0.031853483623032273
6918,Post Tenebras Lux,124279,39185,85094,2012,0.31529864257034573,0.6847013574296542
6919,The Square,124244,124244,0,2013,1.0,0.0
6920,Marguerite & Julien,123918,0,123918,2015,0.0,1.0
6921,Knights of Badassdom,123854,123854,0,2014,1.0,0.0
6922,Wings of Desire 2018 Re-release,123830,123830,0,2018,1.0,0.0
6923,The Magic of Belle Isle,123821,102388,21433,2012,0.8269033524200257,0.1730966475799743
6924,Puncture,123700,68945,54755,2011,0.5573565076798707,0.44264349232012934
6925,Appropriate Behavior,123699,46912,76787,2015,0.37924316283882653,0.6207568371611735
6926,Sigur Rós: Inni,123482,123482,0,2011,1.0,0.0
6927,Easy Rider 2019 Re-release,123276,123276,0,2019,1.0,0.0
6928,The Last Mountain,122961,122961,0,2011,1.0,0.0
6929,Ashby,122919,4631,118288,2015,0.03767521701282959,0.9623247829871704
6930,Secret Ballot,122875,114909,7966,2002,0.9351698880976602,0.06483011190233978
6931,Blood Fest,122833,82774,40059,2018,0.6738742845977872,0.32612571540221275
6932,"14 Days, 12 Nights",122806,122530,276,2020,0.9977525528068661,0.002247447193133886
6933,Do I Sound Gay?,122595,119388,3207,2015,0.9738406949712468,0.026159305028753212
6934,Film socialisme 2010 Re-release,122264,42925,79339,2010,0.3510845383759733,0.6489154616240267
6935,Tragedy Girls,122211,61899,60312,2017,0.506492868890689,0.49350713110931094
6936,Dancing at the Blue Iguana,122121,67913,54208,2001,0.5561123803440849,0.44388761965591506
6937,Howard Zinn: You Can't Be Neutral on a Moving Train,122011,122011,0,2004,1.0,0.0
6938,The Ones Below,121827,12488,109339,2016,0.10250601262445927,0.8974939873755408
6939,Tremors,121813,23911,97902,2019,0.19629267812138276,0.8037073218786173
6940,Yu-Gi-Oh!: The Movie - Pyramid of Light 2018 Re-release,121688,121688,0,2018,1.0,0.0
6941,Fidel,121304,121304,0,2002,1.0,0.0
6942,All the Queen's Men,121258,23662,97596,2001,0.19513764040310744,0.8048623595968926
6943,Letters to Elena,121254,8511,112743,2012,0.07019149883715177,0.9298085011628482
6944,Afflicted,121179,121179,0,2014,1.0,0.0
6945,In Jackson Heights,121094,121094,0,2015,1.0,0.0
6946,Michael,121034,15715,105319,2011,0.12983954921757523,0.8701604507824248
6947,The Girl Without Hands,121020,21787,99233,2016,0.1800280945298298,0.8199719054701702
6948,Miss Sharon Jones!,120880,120880,0,2016,1.0,0.0
6949,Better Living Through Chemistry,120823,75143,45680,2014,0.6219262888688412,0.3780737111311588
6950,Hockney 2016 Re-release,120745,120745,0,2016,1.0,0.0
6951,Cowgirls 'n Angels,120680,120680,0,2012,1.0,0.0
6952,Sons of Provo,120488,120488,0,2005,1.0,0.0
6953,Spark: A Burning Man Story,120459,120459,0,2013,1.0,0.0
6954,I Vitelloni 2003 Re-release,120343,116428,3915,2003,0.9674679873361973,0.03253201266380263
6955,Foodfight!,120141,0,120141,2012,0.0,1.0
6956,Blank City,119929,116037,3892,2011,0.9675474655838038,0.03245253441619625
6957,Avant qu'on explose,119894,119894,0,2019,1.0,0.0
6958,The Pearl Button,119753,42166,77587,2015,0.35210808915016745,0.6478919108498326
6959,Amy's Orgasm,119664,119664,0,2002,1.0,0.0
6960,The Komediant,119506,119506,0,2002,1.0,0.0
6961,Digging for Fire,119364,119364,0,2015,1.0,0.0
6962,Valley of the Heart's Delight,119290,119290,0,2010,1.0,0.0
6963,Celine: Through the Eyes of the World,119274,0,119274,2010,0.0,1.0
6964,Fellini: I'm a Born Liar,119217,106686,12531,2003,0.89488915171494,0.10511084828506001
6965,Remember the Goal,119100,119100,0,2016,1.0,0.0
6966,Home Movie,119052,119052,0,2002,1.0,0.0
6967,Until Forever 2016 Re-release,118795,105358,13437,2016,0.8868891788374932,0.11311082116250684
6968,Neither Heaven Nor Earth,118663,12810,105853,2015,0.10795277382166303,0.892047226178337
6969,The Levelling,118451,3040,115411,2017,0.025664620813669787,0.9743353791863302
6970,See What I'm Saying: The Deaf Entertainers Documentary,118206,118206,0,2010,1.0,0.0
6971,Styx 2018 Re-release,118188,70794,47394,2018,0.5989948218093207,0.40100517819067927
6972,Victor,117755,117755,0,2016,1.0,0.0
6973,The Decoy Bride,117754,759,116995,2011,0.006445640912410619,0.9935543590875894
6974,Freakonomics,117678,101270,16408,2010,0.8605686704396743,0.13943132956032564
6975,Running Free,117608,117608,0,2000,1.0,0.0
6976,Spring Forward,117471,117471,0,2000,1.0,0.0
6977,Bisbee '17,117470,117470,0,2018,1.0,0.0
6978,George Takei's Allegiance 2018 Re-release,117162,117162,0,2018,1.0,0.0
6979,Jauja 2014 Re-release,117117,60231,56886,2014,0.5142805912036681,0.48571940879633185
6980,"Love, Sex and Eating the Bones",116869,116869,0,2004,1.0,0.0
6981,Skin,116863,0,116863,2019,0.0,1.0
6982,Gimme the Loot,116783,104442,12341,2013,0.8943253726997936,0.10567462730020637
6983,A Case of You,116559,4187,112372,2013,0.035921722046345625,0.9640782779536544
6984,The Undefeated,116381,116381,0,2011,1.0,0.0
6985,Touching Home,116353,116353,0,2010,1.0,0.0
6986,The Art of Flight,116134,0,116134,2012,0.0,1.0
6987,Mob Psycho 100,115766,115766,0,2019,1.0,0.0
6988,I Am Divine,115739,81497,34242,2013,0.7041446703358418,0.2958553296641582
6989,Headshot,115511,1373,114138,2011,0.011886313857554691,0.9881136861424453
6990,Loggerheads,115314,115314,0,2005,1.0,0.0
6991,Caged No More,114959,114959,0,2016,1.0,0.0
6992,Sound and Fury,114882,114882,0,2000,1.0,0.0
6993,Nostalgia,114603,114603,0,2018,1.0,0.0
6994,Taboo,114425,114425,0,2000,1.0,0.0
6995,John McEnroe: In the Realm of Perfection,114289,90964,23325,2018,0.795912117526621,0.2040878824733789
6996,Kippur,114283,114283,0,2000,1.0,0.0
6997,After Innocence,114264,114264,0,2005,1.0,0.0
6998,Akira 2001 Re-release,114009,114009,0,2001,1.0,0.0
6999,Ain't in It for My Health: A Film About Levon Helm,113966,113966,0,2013,1.0,0.0
7000,Bodied,113956,113956,0,2018,1.0,0.0
7001,The Woman Who Loves Giraffes,113858,113858,0,2019,1.0,0.0
7002,35 and Ticking,113794,113794,0,2011,1.0,0.0
7003,Seaside,113724,15290,98434,2002,0.13444831346065914,0.8655516865393409
7004,Games People Play: New York,113622,113622,0,2004,1.0,0.0
7005,The Goonies 2013 Re-release,113538,113538,0,2013,1.0,0.0
7006,"We Love You, Sally Carmichael!",113435,113435,0,2017,1.0,0.0
7007,Abacus: Small Enough to Jail,113278,113278,0,2017,1.0,0.0
7008,God the Father,113276,113276,0,2014,1.0,0.0
7009,Burn 2012 Re-release,113173,113173,0,2012,1.0,0.0
7010,Road Hard,113169,113169,0,2015,1.0,0.0
7011,Food of Love,113164,43922,69242,2002,0.38812696617298786,0.6118730338270121
7012,Police Story,113164,113164,0,2019,1.0,0.0
7013,Filmworker,112828,102609,10219,2018,0.9094285106533839,0.09057148934661609
7014,Follow Me: The Yoni Netanyahu Story,112679,112679,0,2012,1.0,0.0
7015,A Boy. A Girl. A Dream.,112552,112552,0,2018,1.0,0.0
7016,The Recall,112357,22943,89414,2017,0.20419733527951084,0.7958026647204891
7017,"Hale County This Morning, This Evening",112282,112282,0,2018,1.0,0.0
7018,The Dawn Wall,112191,112191,0,2018,1.0,0.0
7019,Penton: The John Penton Story,112159,112159,0,2014,1.0,0.0
7020,How Viktor 'The Garlic' Took Alexey 'The Stud' to the Nursing Home,112071,12954,99117,2017,0.11558744010493348,0.8844125598950665
7021,Marwencol,112036,112036,0,2010,1.0,0.0
7022,A Chance in the World,112007,112007,0,2018,1.0,0.0
7023,Una noche,111903,100887,11016,2013,0.9015575989919842,0.09844240100801586
7024,The Producers,111866,111866,0,2002,1.0,0.0
7025,Hometown Legend,111806,111806,0,2002,1.0,0.0
7026,Saint John of Las Vegas,111731,102645,9086,2010,0.9186796860316295,0.08132031396837046
7027,1915,111682,111682,0,2015,1.0,0.0
7028,Thomas in Love,111523,44256,67267,2001,0.3968329402903437,0.6031670597096563
7029,Let's Bring Our Heroes Home,111423,111423,0,2004,1.0,0.0
7030,Rich Hill,111376,111376,0,2014,1.0,0.0
7031,Love the Hard Way,111350,44391,66959,2003,0.39866187696452626,0.6013381230354737
7032,Elevator to the Gallows 2016 Re-release,111267,111267,0,2016,1.0,0.0
7033,"Wild Horse, Wild Ride",111205,111205,0,2012,1.0,0.0
7034,A Paris Education,111197,21598,89599,2018,0.19423185877316834,0.8057681412268317
7035,Strangerland,111107,17472,93635,2015,0.15725381839128047,0.8427461816087195
7036,The Obama Effect,110904,110904,0,2012,1.0,0.0
7037,The Overnighters,110763,110763,0,2014,1.0,0.0
7038,Duran Duran: Unstaged,110746,110746,0,2014,1.0,0.0
7039,Word Wars,110617,110617,0,2004,1.0,0.0
7040,In the Face of Evil: Reagan's War in Word and Deed,110577,110577,0,2004,1.0,0.0
7041,The Perfect Family,110313,110313,0,2012,1.0,0.0
7042,The Trouble with Terkel,110289,110289,0,2017,1.0,0.0
7043,Roar,110048,110048,0,2015,1.0,0.0
7044,Best Worst Movie,109895,109895,0,2010,1.0,0.0
7045,The Fifth Element 2017 Re-release,109786,0,109786,2017,0.0,1.0
7046,Babylon,109749,109749,0,2019,1.0,0.0
7047,Zero Days,109649,109649,0,2016,1.0,0.0
7048,Anohana the Movie: The Flower We Saw That Day (Ano hi mita hana no namae wo bokutachi wa mada shiran,109630,109630,0,2014,1.0,0.0
7049,Cameraperson,109464,102033,7431,2016,0.9321146678360008,0.06788533216399913
7050,Wedding Party 2,109459,11140,98319,2017,0.10177326670260098,0.898226733297399
7051,Blood Done Sign My Name,109383,109383,0,2010,1.0,0.0
7052,The Lure,108846,101657,7189,2017,0.9339525568234018,0.06604744317659814
7053,Adult Beginners,108808,108808,0,2015,1.0,0.0
7054,Sworn Virgin,108681,4636,104045,2015,0.042656950156881146,0.9573430498431188
7055,Monsieur N. 2004 Re-release,108631,37757,70874,2004,0.34757113531128314,0.6524288646887169
7056,Red Sorghum,108371,0,108371,2018,0.0,1.0
7057,Violet & Daisy,108139,17186,90953,2013,0.15892508715634507,0.8410749128436549
7058,Bettie Page Reveals All,108118,108118,0,2013,1.0,0.0
7059,Downtown 81,108058,108058,0,2001,1.0,0.0
7060,"Love, Cecil",107940,106057,1883,2017,0.9825551232166018,0.017444876783398185
7061,Kidnapping of Michel Houellebecq,107641,11546,96095,2014,0.10726396075844706,0.892736039241553
7062,Bonjour Monsieur Shlomi,107585,107585,0,2004,1.0,0.0
7063,Revenge of the Green Dragons,107412,0,107412,2014,0.0,1.0
7064,"No Date, No Signature",107368,36444,70924,2018,0.3394307428656583,0.6605692571343417
7065,Cockneys vs Zombies,107348,0,107348,2012,0.0,1.0
7066,Marebito,107259,13983,93276,2005,0.1303666825161525,0.8696333174838475
7067,A Slipping-Down Life,107099,107099,0,2004,1.0,0.0
7068,National Theatre Live: Julius Caesar,107057,107057,0,2018,1.0,0.0
7069,Carlos Castaneda: Enigma of a Sorcerer,107040,107040,0,2004,1.0,0.0
7070,Jeruzalem,107024,11287,95737,2016,0.10546232620720586,0.8945376737927941
7071,Best Worst Thing That Ever Could Have Happened...,106986,106986,0,2016,1.0,0.0
7072,The Tales of Hoffmann,106860,91930,14930,2015,0.8602844843720756,0.1397155156279244
7073,Ivory Tower,106771,106771,0,2014,1.0,0.0
7074,Vita Activa: The Spirit of Hannah Arendt,106768,82143,24625,2016,0.7693597332534092,0.23064026674659074
7075,Dekalog 2016 Re-release,106494,106494,0,2016,1.0,0.0
7076,Wrong,106425,46021,60404,2012,0.4324265914963589,0.567573408503641
7077,The Charmer,106379,26167,80212,2018,0.24597899961458558,0.7540210003854144
7078,Six Dance Lessons in Six Weeks,106323,106323,0,2014,1.0,0.0
7079,The Bachelors,106212,0,106212,2017,0.0,1.0
7080,Almost Peaceful 2004 Re-release,106184,106184,0,2004,1.0,0.0
7081,The Brink,106057,106057,0,2019,1.0,0.0
7082,Big Star: Nothing Can Hurt Me,105998,105998,0,2013,1.0,0.0
7083,The Million Dollar Hotel,105983,59989,45994,2000,0.566024739816763,0.43397526018323695
7084,Never Heard,105271,105271,0,2018,1.0,0.0
7085,Guerrilla: The Taking of Patty Hearst,105054,105054,0,2004,1.0,0.0
7086,Cold Case Hammarskjöld,104965,104965,0,2019,1.0,0.0
7087,The Girl,104883,104883,0,2001,1.0,0.0
7088,A Ciambra,104808,41934,62874,2017,0.4001030455690405,0.5998969544309595
7089,Dictator,104734,104734,0,2016,1.0,0.0
7090,Band Baaja Baaraat,104532,43820,60712,2010,0.4192017755328512,0.5807982244671488
7091,Results,104507,104507,0,2015,1.0,0.0
7092,Big Bad Love,104294,104294,0,2002,1.0,0.0
7093,Human Traffic,104257,104257,0,2000,1.0,0.0
7094,XX/XY,104130,104130,0,2003,1.0,0.0
7095,Demon,104038,104038,0,2016,1.0,0.0
7096,Lola,103951,103951,0,2001,1.0,0.0
7097,World Traveler,103863,103863,0,2002,1.0,0.0
7098,The Investigator,103739,103739,0,2013,1.0,0.0
7099,30 Years to Life,103540,103540,0,2002,1.0,0.0
7100,Stevie,103401,103401,0,2003,1.0,0.0
7101,Stevie Nicks: In Your Dreams,103028,103028,0,2013,1.0,0.0
7102,Puerto Ricans in Paris,102890,102890,0,2016,1.0,0.0
7103,Brake,102819,4876,97943,2012,0.047423141637246036,0.952576858362754
7104,Pure,102471,102471,0,2005,1.0,0.0
7105,The Gracefield Incident,102256,0,102256,2017,0.0,1.0
7106,Tanna,102225,46654,55571,2016,0.45638542430912205,0.543614575690878
7107,Andrei Rublev 2018 Re-release,102021,102021,0,2018,1.0,0.0
7108,Becoming Traviata,102015,62652,39363,2013,0.6141449786796059,0.38585502132039406
7109,Tower,101987,101987,0,2016,1.0,0.0
7110,In the Family,101934,101934,0,2011,1.0,0.0
7111,Hotel by the River,101879,28354,73525,2019,0.2783105448620422,0.7216894551379578
7112,Kill Me Three Times,101807,24296,77511,2015,0.23864763719587062,0.7613523628041294
7113,Magnus,101739,8944,92795,2016,0.08791122381780832,0.9120887761821916
7114,Those Who Remained,101737,0,101737,2019,0.0,1.0
7115,Rubber,101729,100370,1359,2011,0.9866409774990416,0.01335902250095843
7116,Kickboxer: Retaliation,101690,4537,97153,2018,0.044615989772839024,0.955384010227161
7117,QT8: The First Eight,101616,51896,49720,2019,0.5107069752794835,0.48929302472051645
7118,A Lego Brickumentary,101531,101531,0,2015,1.0,0.0
7119,Blazing Saddles 2013 Re-release,101481,101481,0,2013,1.0,0.0
7120,Man from Reno,101438,101438,0,2015,1.0,0.0
7121,James White,101368,101368,0,2015,1.0,0.0
7122,Emerald Cowboy,101358,101358,0,2003,1.0,0.0
7123,Korengal,101310,101310,0,2014,1.0,0.0
7124,Feed the Fish,101170,101170,0,2010,1.0,0.0
7125,Beyond Sight: The Derek Rabelo Story,101074,101074,0,2014,1.0,0.0
7126,First Cow,101068,101068,0,2020,1.0,0.0
7127,Dum,101000,101000,0,2003,1.0,0.0
7128,Khauff,100975,100975,0,2000,1.0,0.0
7129,The Good Guy,100688,100688,0,2010,1.0,0.0
7130,A Woman Is a Woman,100665,100665,0,2003,1.0,0.0
7131,Sade,100544,100544,0,2002,1.0,0.0
7132,The Man Who Fell to Earth,100468,100072,396,2011,0.996058446470518,0.003941553529482024
7133,The United States of Autism,100403,100403,0,2013,1.0,0.0
7134,One Track Heart: The Story of Krishna Das,100401,100401,0,2013,1.0,0.0
7135,All About Nina,100335,100335,0,2018,1.0,0.0
7136,8: The Mormon Proposition,100280,100280,0,2010,1.0,0.0
7137,Rejoice and Shout,100237,100237,0,2011,1.0,0.0
7138,Bhutto,100202,100202,0,2010,1.0,0.0
7139,Fighter,99938,99938,0,2001,1.0,0.0
7140,Yves Saint Laurent: His Life and Times,99819,99819,0,2004,1.0,0.0
7141,White Lion,99635,0,99635,2010,0.0,1.0
7142,Heavy Water,99503,55446,44057,2019,0.5572294302684341,0.44277056973156587
7143,Meow Wolf: Origin Story,99488,99488,0,2018,1.0,0.0
7144,Kings of the Evening,99270,99270,0,2010,1.0,0.0
7145,Carnage,99049,60158,38891,2002,0.6073559551333179,0.39264404486668214
7146,Cemetery of Splendor,98932,51950,46982,2015,0.5251081550964298,0.4748918449035701
7147,Handcart,98666,98666,0,2002,1.0,0.0
7148,High Strung Free Dance 2019 Re-release,98481,83891,14590,2019,0.8518495953534184,0.14815040464658158
7149,Aida's Secrets,98468,98468,0,2017,1.0,0.0
7150,Reign of Judges: Title of Liberty - Concept Short,98408,93224,5184,2018,0.9473213559873181,0.052678644012681894
7151,Blind,98280,12522,85758,2017,0.1274114774114774,0.8725885225885226
7152,Charlie Says,98240,40685,57555,2019,0.41413884364820847,0.5858611563517915
7153,National Theatre Live: Macbeth,97857,97857,0,2018,1.0,0.0
7154,"Tim Timmerman, Hope of America",97727,97727,0,2017,1.0,0.0
7155,The Here After,97699,0,97699,2015,0.0,1.0
7156,On Guard,97552,97552,0,2002,1.0,0.0
7157,D.E.B.S.,97446,97446,0,2005,1.0,0.0
7158,Aileen: Life and Death of a Serial Killer,97362,97362,0,2004,1.0,0.0
7159,Everybody's Famous!,97353,81734,15619,2001,0.8395632389345988,0.16043676106540117
7160,In Bloom,97236,56092,41144,2013,0.5768645357686454,0.4231354642313546
7161,Difret,97205,49667,47538,2015,0.5109510827632323,0.48904891723676763
7162,Prassthanam,97204,19984,77220,2019,0.20558824739722645,0.7944117526027735
7163,A Field in England,97195,32846,64349,2013,0.3379391944030043,0.6620608055969958
7164,Little Monsters,97111,0,97111,2019,0.0,1.0
7165,Kisses 2010 Re-release,96933,81680,15253,2010,0.8426438880463826,0.15735611195361746
7166,A Little Help,96868,96868,0,2011,1.0,0.0
7167,Leviathan,96778,76202,20576,2013,0.7873896960052904,0.21261030399470954
7168,Singin' in the Rain 2013 Re-release,96763,96763,0,2013,1.0,0.0
7169,Hardflip,96734,96734,0,2012,1.0,0.0
7170,Sunshine Superman,96715,88097,8618,2015,0.9108928294473453,0.08910717055265471
7171,Godspeed: The Race Across America,96690,96690,0,2018,1.0,0.0
7172,Paragraph 175,96630,96630,0,2000,1.0,0.0
7173,A Poem Is a Naked Person,96592,96592,0,2015,1.0,0.0
7174,Dina,96524,90503,6021,2017,0.9376217313828685,0.06237826861713149
7175,Hiroshima Mon Amour 2014 Re-release,96439,96439,0,2014,1.0,0.0
7176,Autumn Spring 2003 Re-release,96269,96269,0,2003,1.0,0.0
7177,Saint Judy,96212,78935,17277,2019,0.8204278052633767,0.17957219473662328
7178,My Reincarnation,96115,92822,3293,2011,0.9657389585392498,0.034261041460750145
7179,A Bigger Splash 2019 Re-release,95826,95826,0,2019,1.0,0.0
7180,Ardor,95549,18565,76984,2014,0.19429821348208773,0.8057017865179122
7181,The Lovers & the Despot,95521,55511,40010,2016,0.5811392259293768,0.4188607740706232
7182,Kehtaa Hai Dil Baar Baar,95415,95415,0,2002,1.0,0.0
7183,Classe Tous Risques,95413,95413,0,2005,1.0,0.0
7184,Code Unknown,95242,95242,0,2001,1.0,0.0
7185,The Final Wish,95215,25183,70032,2019,0.26448563776715855,0.7355143622328415
7186,The Night Eats the World,95208,0,95208,2018,0.0,1.0
7187,Queen of Earth,95183,91218,3965,2015,0.958343401657859,0.04165659834214093
7188,Saala Khadoos,94787,76931,17856,2016,0.8116197368837499,0.1883802631162501
7189,The Hebrew Hammer,94615,82157,12458,2003,0.8683295460550653,0.13167045394493473
7190,Jin-Roh: The Wolf Brigade,94591,94591,0,2001,1.0,0.0
7191,The Fight Within,94326,94326,0,2016,1.0,0.0
7192,Papi Chulo,94321,84703,9618,2019,0.8980290709386033,0.10197092906139672
7193,Keep Watching,94178,94178,0,2017,1.0,0.0
7194,Escaflowne: The Movie,94060,94060,0,2002,1.0,0.0
7195,Blue Caprice,93995,93995,0,2013,1.0,0.0
7196,Let the Corpses Tan,93409,93409,0,2018,1.0,0.0
7197,Flavors,93370,93370,0,2004,1.0,0.0
7198,Will You Still Love Me Tomorrow?,93046,6694,86352,2013,0.07194290995851514,0.9280570900414848
7199,Celsius 41.11: The Temperature at Which the Brain... Begins to Die,93000,93000,0,2004,1.0,0.0
7200,Vamps,92748,3361,89387,2012,0.03623797817742701,0.963762021822573
7201,Haiku Tunnel,92723,92723,0,2001,1.0,0.0
7202,The First Time,92654,22836,69818,2012,0.24646534418373733,0.7535346558162627
7203,American: The Bill Hicks Story,92234,92234,0,2011,1.0,0.0
7204,Into the Forest,92166,9995,82171,2016,0.10844563070980621,0.8915543692901938
7205,Nancy,92000,80115,11885,2018,0.8708152173913043,0.12918478260869565
7206,Generation War,91595,91595,0,2014,1.0,0.0
7207,Legends from the Sky,91462,91462,0,2015,1.0,0.0
7208,Other People,91441,91441,0,2016,1.0,0.0
7209,Evil Bong 3: The Wrath of Bong,91260,91260,0,2011,1.0,0.0
7210,Morris from America,91151,91151,0,2016,1.0,0.0
7211,A Kind of Murder,91149,2915,88234,2016,0.03198060318818638,0.9680193968118136
7212,Mapplethorpe,91002,91002,0,2019,1.0,0.0
7213,BANDSTAND: The Broadway Musical on Screen 2018 Re-release,91000,91000,0,2018,1.0,0.0
7214,Undead 2005 Re-release,90928,41196,49732,2005,0.45306176315326413,0.5469382368467359
7215,Because of Grácia,90878,90878,0,2017,1.0,0.0
7216,Ek Khiladi Ek Haseena,90869,90869,0,2005,1.0,0.0
7217,Porto,90849,15126,75723,2017,0.16649605389162236,0.8335039461083776
7218,Heroic Antics,90785,63649,27136,2014,0.7010959960345872,0.2989040039654128
7219,Beasts of No Nation,90777,90777,0,2015,1.0,0.0
7220,Yuri!!! On Ice,90751,81878,8873,2018,0.902226972705535,0.09777302729446508
7221,Loopers: The Caddie's Long Walk,90679,90679,0,2019,1.0,0.0
7222,Moonwalkers,90646,0,90646,2016,0.0,1.0
7223,The Good Neighbor,90573,0,90573,2016,0.0,1.0
7224,Fireworks Wednesday 2016 Re-release,90519,90519,0,2016,1.0,0.0
7225,Minding the Gap,90328,11998,78330,2018,0.1328270303781773,0.8671729696218227
7226,Dark Horse,90136,90136,0,2015,1.0,0.0
7227,King's Faith,90106,90106,0,2013,1.0,0.0
7228,Running for Grace,89988,89988,0,2018,1.0,0.0
7229,Pump,89787,89787,0,2014,1.0,0.0
7230,Eulogy,89781,75076,14705,2004,0.8362125616778606,0.16378743832213943
7231,The Principle,89543,89543,0,2014,1.0,0.0
7232,Oy Vey! My Son Is Gay!!,89507,89507,0,2010,1.0,0.0
7233,Somebody Up There Likes Me,89435,89435,0,2013,1.0,0.0
7234,Cat on a Hot Tin Roof,89332,89332,0,2018,1.0,0.0
7235,Salvation Boulevard,89182,28468,60714,2011,0.31921239712049515,0.6807876028795048
7236,Night of the Living Dead,89029,89029,0,2017,1.0,0.0
7237,This Is Not a Film,88758,77016,11742,2012,0.8677076995876428,0.1322923004123572
7238,The Lumber Baron,88336,88336,0,2019,1.0,0.0
7239,Crazy on the Outside,88335,88335,0,2010,1.0,0.0
7240,Jewtopia,88327,46437,41890,2013,0.5257395813284726,0.4742604186715274
7241,Money for Nothing: Inside the Federal Reserve,88045,88045,0,2013,1.0,0.0
7242,Jim Allison: Breakthrough,87984,87984,0,2019,1.0,0.0
7243,Seeing Other People,87923,87923,0,2004,1.0,0.0
7244,Rosie,87788,6839,80949,2019,0.0779035859115141,0.9220964140884859
7245,Hyena Road,87768,1430,86338,2015,0.01629295415185489,0.9837070458481451
7246,The Cartel,87763,87763,0,2010,1.0,0.0
7247,Ocean Waves,87738,87738,0,2016,1.0,0.0
7248,Glory,87728,18415,69313,2017,0.2099101769104505,0.7900898230895496
7249,Exporting Raymond,87727,87727,0,2011,1.0,0.0
7250,Author: The JT LeRoy Story,87686,85999,1687,2016,0.9807608968364391,0.019239103163560888
7251,Goldstone 2018 Re-release,87639,87639,0,2018,1.0,0.0
7252,Pulse 2005 Re-release,87420,51420,36000,2005,0.5881949210706932,0.4118050789293068
7253,Borstal Boy,87400,87400,0,2002,1.0,0.0
7254,First Morning,87264,87264,0,2005,1.0,0.0
7255,To Fall in Love,87000,87000,0,2000,1.0,0.0
7256,War Photographer,86863,61040,25823,2002,0.7027157708115078,0.29728422918849223
7257,ECCO,86858,86858,0,2019,1.0,0.0
7258,Singularity,86822,4176,82646,2017,0.04809840823754348,0.9519015917624565
7259,Vault,86741,29491,57250,2019,0.3399891631408446,0.6600108368591554
7260,Gueros,86736,60114,26622,2015,0.6930686220254566,0.30693137797454345
7261,School Life,86616,37381,49235,2017,0.4315715341276439,0.5684284658723562
7262,Beuys,86451,65410,21041,2018,0.7566135730066743,0.2433864269933257
7263,"My Love, Don't Cross That River 2016 Re-release",86446,86446,0,2016,1.0,0.0
7264,Prey for Rock & Roll,86277,58040,28237,2003,0.6727169465790419,0.3272830534209581
7265,Crazy Wisdom: The Life & Times of Chogyam Trungpa Rinpoche,86202,86202,0,2011,1.0,0.0
7266,Rapt 2011 Re-release,86028,45759,40269,2011,0.5319082159296973,0.4680917840703027
7267,Bay of Angels,85840,85840,0,2001,1.0,0.0
7268,Tab Hunter Confidential,85812,85812,0,2015,1.0,0.0
7269,Where's the Party Yaar?,85739,85739,0,2003,1.0,0.0
7270,Jackals,85410,0,85410,2017,0.0,1.0
7271,The Good Old Naughty Days,85006,60862,24144,2002,0.7159729901418723,0.2840270098581277
7272,Skid Row Marathon,84997,84997,0,2019,1.0,0.0
7273,Three... Extremes 2005 Re-release,84976,77532,7444,2005,0.9123987949538693,0.08760120504613067
7274,Waking Sleeping Beauty,84918,80741,4177,2010,0.9508113709696413,0.0491886290303587
7275,Ran 2016 Re-release,84789,66097,18692,2016,0.779546875184281,0.22045312481571902
7276,Decoys,84733,84733,0,2004,1.0,0.0
7277,Live Nude Girls Unite!,84706,84706,0,2000,1.0,0.0
7278,Wretches & Jabberers,84610,84610,0,2011,1.0,0.0
7279,Visitors,84577,84577,0,2014,1.0,0.0
7280,Woodstock,84440,84440,0,2019,1.0,0.0
7281,Heaven Knows What,84417,80734,3683,2015,0.9563713470035656,0.04362865299643437
7282,The Diabolical,84259,0,84259,2015,0.0,1.0
7283,Chapter & Verse,84147,84147,0,2017,1.0,0.0
7284,Los Sures,83992,83992,0,2016,1.0,0.0
7285,The Disappearance of My Mother,83930,24951,58979,2019,0.29728345049445964,0.7027165495055403
7286,"Nico, 1988",83558,73304,10254,2018,0.8772828454486704,0.12271715455132962
7287,Barely Legal,83439,26511,56928,2005,0.3177291194765038,0.6822708805234962
7288,ABCD,83372,83372,0,2001,1.0,0.0
7289,The Look,83137,19988,63149,2011,0.2404224352574666,0.7595775647425335
7290,Hateship Loveship,83008,54030,28978,2014,0.6509011179645335,0.34909888203546646
7291,Alien Abduction,82725,12897,69828,2014,0.15590208522212148,0.8440979147778785
7292,Doctor Who: The Woman Who Fell to Earth,82698,82698,0,2018,1.0,0.0
7293,12 O'Clock Boys,82614,82614,0,2014,1.0,0.0
7294,Funny Ha Ha,82528,77070,5458,2005,0.9338648701046918,0.06613512989530826
7295,V/H/S Viral,82409,2756,79653,2014,0.033442949192442575,0.9665570508075574
7296,The Treasure,82392,50203,32189,2016,0.6093188659093116,0.39068113409068844
7297,Better Living Through Circuitry,82378,82378,0,2000,1.0,0.0
7298,Water & Power,82312,82312,0,2014,1.0,0.0
7299,Prey,82258,0,82258,2019,0.0,1.0
7300,Careful What You Wish For,82230,0,82230,2015,0.0,1.0
7301,The Whale,81881,81881,0,2011,1.0,0.0
7302,Bhavesh Joshi Superhero,81792,57376,24416,2018,0.7014866979655712,0.2985133020344288
7303,Best Man in Grass Creek,81760,81760,0,2001,1.0,0.0
7304,King Cobra,81757,81757,0,2016,1.0,0.0
7305,Inkubus,81600,81600,0,2011,1.0,0.0
7306,'R Xmas,81476,850,80626,2001,0.010432520005891305,0.9895674799941087
7307,Anything But Love,81451,81451,0,2003,1.0,0.0
7308,A State of Mind,81450,41468,39982,2005,0.509122160834868,0.490877839165132
7309,Hating Breitbart,81432,81432,0,2012,1.0,0.0
7310,The Girl in the Book,81379,8245,73134,2015,0.10131606434092333,0.8986839356590767
7311,The Future of Food,81280,81280,0,2005,1.0,0.0
7312,Yomeddine,81030,11308,69722,2018,0.139553251882019,0.8604467481179809
7313,The Island President,80996,76398,4598,2012,0.9432317645315818,0.05676823546841819
7314,Burning Bush,80943,16731,64212,2013,0.2067010118231348,0.7932989881768652
7315,Woman Walks Ahead,80912,57528,23384,2018,0.7109946608661262,0.28900533913387383
7316,Brother to Brother,80906,80906,0,2004,1.0,0.0
7317,The Big Blue 2000 Director's Cut,80882,80882,0,2000,1.0,0.0
7318,Taur Mittran Di,80879,69510,11369,2012,0.8594319909988996,0.14056800900110042
7319,Chrystal,80858,80858,0,2005,1.0,0.0
7320,Kind Hearts and Coronets 2019 Re-release,80795,35948,44847,2019,0.444928522804629,0.555071477195371
7321,Nasty Baby,80772,79800,972,2015,0.98796612687565,0.012033873124350022
7322,Trace Amounts,80735,80735,0,2015,1.0,0.0
7323,Batman Returns 2019 Re-release,80699,70642,10057,2019,0.8753763987162171,0.12462360128378294
7324,Ms. Purple,80657,80657,0,2019,1.0,0.0
7325,Enemies of the People,80654,73171,7483,2010,0.9072209685818434,0.09277903141815658
7326,Winnie Mandela,80634,80634,0,2013,1.0,0.0
7327,Always Kabhi Kabhi,80546,21381,59165,2011,0.26545079830159163,0.7345492016984083
7328,Ginger Snaps 2: Unleashed,80372,80372,0,2004,1.0,0.0
7329,Free Radicals,80371,1443,78928,2003,0.017954237224869666,0.9820457627751303
7330,Songs from the Second Floor,80334,80334,0,2001,1.0,0.0
7331,Armstrong,80169,19740,60429,2019,0.24622983946413202,0.753770160535868
7332,For the Love of Spock,80141,80141,0,2016,1.0,0.0
7333,Inhale,80112,4115,75997,2010,0.051365588176552825,0.9486344118234472
7334,Ramaiya Vastavaiya,80108,80108,0,2013,1.0,0.0
7335,Jack Paradise (Les nuits de Montréal),79974,79974,0,2004,1.0,0.0
7336,Searching for the Wrong-Eyed Jesus,79916,79916,0,2005,1.0,0.0
7337,En el séptimo día,79887,79887,0,2018,1.0,0.0
7338,Made-Up,79766,79766,0,2003,1.0,0.0
7339,"Sobibór, October 14, 1943, 4 p.m.",79728,41040,38688,2001,0.5147501505117399,0.4852498494882601
7340,Aurangzeb,79665,0,79665,2013,0.0,1.0
7341,Harvest of Empire,79627,79627,0,2012,1.0,0.0
7342,Camp X-Ray,79624,13302,66322,2014,0.16706018285943935,0.8329398171405606
7343,End of the Century,79607,66309,13298,2019,0.832954388433178,0.16704561156682202
7344,Jayne Mansfield's Car,79178,14836,64342,2013,0.18737528101240244,0.8126247189875976
7345,Concussion,78957,42606,36351,2013,0.5396101675595577,0.4603898324404423
7346,Fort McCoy,78948,78948,0,2014,1.0,0.0
7347,Christ Stopped at Eboli,78736,78736,0,2019,1.0,0.0
7348,The Boxcar Children - Surprise Island,78676,78676,0,2018,1.0,0.0
7349,Blackbird,78400,78400,0,2015,1.0,0.0
7350,Harold and Lillian: A Hollywood Love Story,78301,78301,0,2017,1.0,0.0
7351,Colliding Dreams,78288,78288,0,2016,1.0,0.0
7352,Anesthesia,78270,32163,46107,2016,0.41092372556535073,0.5890762744346493
7353,Un traductor,78075,13509,64566,2018,0.17302593659942364,0.8269740634005763
7354,Jodi Breakers,78024,52618,25406,2012,0.6743822413616323,0.32561775863836767
7355,Bright Leaves,77888,77888,0,2004,1.0,0.0
7356,Baraka 2002 Re-release,77873,77873,0,2002,1.0,0.0
7357,Table No. 21,77621,46720,30901,2013,0.6018989706393888,0.39810102936061115
7358,Chevalier,77590,25696,51894,2015,0.3311766980280964,0.6688233019719036
7359,The Princess Blade,77567,77567,0,2003,1.0,0.0
7360,Circo,77466,77466,0,2011,1.0,0.0
7361,The Art of the Steal,77450,64065,13385,2014,0.8271788250484183,0.17282117495158167
7362,Breaking Upwards,77389,77389,0,2010,1.0,0.0
7363,To Catch a Dollar: Muhammad Yunus Banks on America,77142,77142,0,2011,1.0,0.0
7364,Parchi,77110,69431,7679,2018,0.9004149915704838,0.09958500842951627
7365,The Missing Picture,76933,52164,24769,2014,0.6780445322553391,0.32195546774466094
7366,Fast Colour,76916,76916,0,2019,1.0,0.0
7367,How the West Was Won 2003 Re-release,76729,76729,0,2003,1.0,0.0
7368,Eisenstein in Guanajuato 2015 Re-release,76713,34282,42431,2015,0.4468864468864469,0.5531135531135531
7369,Mademoiselle C,76621,48668,27953,2013,0.6351783453622375,0.3648216546377625
7370,Blue Moon,76544,76544,0,2000,1.0,0.0
7371,The New Rijksmuseum - The Film,76460,40578,35882,2015,0.5307088673816375,0.4692911326183625
7372,Steal This Movie,76424,76424,0,2000,1.0,0.0
7373,Swimming Upstream 2004 Re-release,76287,54965,21322,2004,0.7205028379671503,0.27949716203284963
7374,Night Catches Us,76185,76185,0,2010,1.0,0.0
7375,Don't Blink,76134,76134,0,2016,1.0,0.0
7376,93Queen,76056,76056,0,2018,1.0,0.0
7377,Greener Grass,76045,51456,24589,2019,0.6766519823788546,0.3233480176211454
7378,Whitey: United States of America v. James J. Bulger,75881,75881,0,2014,1.0,0.0
7379,Wish You Were Here 2013 Re-release,75870,46347,29523,2013,0.6108738631870304,0.38912613681296954
7380,Into the White 2013 Re-release,75747,704,75043,2013,0.009294097456004858,0.9907059025439952
7381,Touch Me Not,75507,13782,61725,2018,0.18252612340577695,0.8174738765942231
7382,The Riot Act,75506,75506,0,2018,1.0,0.0
7383,Swim Little Fish Swim,75504,3877,71627,2014,0.05134827293918203,0.948651727060818
7384,Hum To Mohabbat Karega,75446,75446,0,2000,1.0,0.0
7385,Restaurant,75232,75232,0,2000,1.0,0.0
7386,An Everlasting Piece,75228,75228,0,2000,1.0,0.0
7387,Widespread Panic: The Earth Will Swallow You,75204,75204,0,2002,1.0,0.0
7388,Bill Nye: Science Guy,74909,74909,0,2017,1.0,0.0
7389,Where Is Kyra?,74821,59717,15104,2018,0.7981315406102565,0.20186845938974352
7390,The Ornithologist,74714,50511,24203,2016,0.6760580346387558,0.3239419653612442
7391,Above and Beyond: NASA's Journey to Tomorrow,74711,74711,0,2018,1.0,0.0
7392,Batkid Begins: The Wish Heard Around the World,74709,74709,0,2015,1.0,0.0
7393,The Monster,74700,12544,62156,2016,0.16792503346720214,0.8320749665327979
7394,The War Within,74655,74655,0,2005,1.0,0.0
7395,We Come as Friends,74633,50921,23712,2014,0.6822853161470127,0.3177146838529873
7396,The Nomi Song,74631,74631,0,2005,1.0,0.0
7397,Hadewijch,74586,5006,69580,2010,0.0671171533531762,0.9328828466468237
7398,Stations of the Cross,74509,1505,73004,2014,0.02019890214604947,0.9798010978539505
7399,Reset,74341,5454,68887,2016,0.07336463055379938,0.9266353694462006
7400,Set Me Free,74052,74052,0,2000,1.0,0.0
7401,The Boy Downstairs,73988,13638,60350,2018,0.1843271881926799,0.8156728118073201
7402,The Keeping Room,73922,27166,46756,2015,0.3674954681962068,0.6325045318037932
7403,After Auschwitz,73885,73885,0,2018,1.0,0.0
7404,War Pigs,73701,0,73701,2015,0.0,1.0
7405,Wait for Your Laugh,73585,73585,0,2017,1.0,0.0
7406,Prodigal Sons,73544,73544,0,2010,1.0,0.0
7407,On the Ice,73492,73492,0,2012,1.0,0.0
7408,Primal Rage: The Legend of Konga,73383,21497,51886,2018,0.2929425071201777,0.7070574928798223
7409,Father and Son,73351,39291,34060,2004,0.5356573189186241,0.46434268108137583
7410,Vengeance: A Love Story,73270,4526,68744,2017,0.06177152995769073,0.9382284700423092
7411,Te Ata,73236,73236,0,2017,1.0,0.0
7412,Antonio Lopez 1970: Sex Fashion & Disco,73122,43169,29953,2018,0.5903695194332759,0.40963048056672413
7413,Buster's Mal Heart,73121,73121,0,2017,1.0,0.0
7414,Headshot,73010,0,73010,2017,0.0,1.0
7415,5B,72968,72968,0,2019,1.0,0.0
7416,Come Away Home,72810,72810,0,2005,1.0,0.0
7417,Do Not Resist,72791,72791,0,2016,1.0,0.0
7418,The Seagull's Laughter,72527,72527,0,2004,1.0,0.0
7419,Dorian Blues,72234,72234,0,2005,1.0,0.0
7420,Loving Jezebel,72190,72190,0,2000,1.0,0.0
7421,The Green Wave,72152,0,72152,2011,0.0,1.0
7422,Partisan,72151,0,72151,2015,0.0,1.0
7423,After Tiller,72125,72125,0,2013,1.0,0.0
7424,Hollywood Buddha,72115,72115,0,2004,1.0,0.0
7425,Veil of Tears,72078,72078,0,2014,1.0,0.0
7426,Naked in Ashes,72073,72073,0,2005,1.0,0.0
7427,The Invisible War,71968,71968,0,2012,1.0,0.0
7428,The Chambermaid Lynn,71918,315,71603,2015,0.004379988320031147,0.9956200116799688
7429,Raiders!: The Story of the Greatest Fan Film Ever Made,71916,71916,0,2016,1.0,0.0
7430,An Oversimplification of Her Beauty,71906,71906,0,2013,1.0,0.0
7431,Umberto D.,71816,71816,0,2002,1.0,0.0
7432,As I Lay Dying,71759,16697,55062,2013,0.23268161484970526,0.7673183851502947
7433,New Suit,71743,71743,0,2003,1.0,0.0
7434,Runaway Slave,71737,71737,0,2012,1.0,0.0
7435,Flamenco Flamenco 2014 Re-release,71732,71732,0,2014,1.0,0.0
7436,"Je t'aime, je t'aime 2014 Re-release",71717,71717,0,2014,1.0,0.0
7437,The Dummy,71646,71646,0,2003,1.0,0.0
7438,Herman U.S.A.,71509,71509,0,2001,1.0,0.0
7439,The Congressman,71451,71451,0,2016,1.0,0.0
7440,The Sicilian Girl 2010 Re-release,71239,71239,0,2010,1.0,0.0
7441,My Journey Through French Cinema,71174,52214,18960,2016,0.7336105881361171,0.2663894118638829
7442,Free Trip to Egypt 2019 Re-release,71087,71087,0,2019,1.0,0.0
7443,Boricua's Bond,71046,71046,0,2000,1.0,0.0
7444,Rosencrantz and Guildenstern Are Undead,71007,71007,0,2010,1.0,0.0
7445,Freaks of Nature,70958,70958,0,2015,1.0,0.0
7446,Norman Lear: Just Another Version of You,70950,70950,0,2016,1.0,0.0
7447,Todo el poder,70920,70920,0,2003,1.0,0.0
7448,The Better Angels,70918,70918,0,2014,1.0,0.0
7449,4:44 Last Day on Earth,70851,17801,53050,2012,0.2512455716927072,0.7487544283072928
7450,Seasons of Gray,70605,70605,0,2013,1.0,0.0
7451,Fireflies in the Garden 2011 Re-release,70600,70600,0,2011,1.0,0.0
7452,Snipes,70569,70569,0,2002,1.0,0.0
7453,Go for Sisters,70495,70495,0,2013,1.0,0.0
7454,The Fog 2018 Re-release,70421,70421,0,2018,1.0,0.0
7455,Over Your Cities Grass Will Grow,70256,51301,18955,2010,0.7302009792757914,0.2697990207242086
7456,Wastelander,70045,70045,0,2018,1.0,0.0
7457,Manic,69958,69958,0,2003,1.0,0.0
7458,Turn It Around: The Story of East Bay Punk,69787,69787,0,2017,1.0,0.0
7459,Mga munting tinig,69739,69739,0,2003,1.0,0.0
7460,Assassination of a High School President,69564,0,69564,2010,0.0,1.0
7461,Dopamine,69544,69544,0,2003,1.0,0.0
7462,Chef Flynn,69542,68407,1135,2018,0.9836789278421674,0.016321072157832676
7463,Back to the Jurassic,69423,4351,65072,2015,0.0626737536551287,0.9373262463448713
7464,An Inconsistent Truth,69394,69394,0,2012,1.0,0.0
7465,BBC2 Play of the Week: Langrishe Go Down,69338,69338,0,2002,1.0,0.0
7466,Siddharth,69310,60537,8773,2014,0.8734237483768575,0.1265762516231424
7467,Rocky Handsome,69289,0,69289,2016,0.0,1.0
7468,Girls Can't Swim,69250,69250,0,2002,1.0,0.0
7469,Bajatey Raho,69085,55397,13688,2013,0.8018672649634508,0.19813273503654918
7470,The Pinochet Case,68934,35701,33233,2001,0.5179011808396438,0.4820988191603563
7471,My Entire High School Sinking Into the Sea,68883,68883,0,2017,1.0,0.0
7472,Klown 2012 Re-release,68795,68795,0,2012,1.0,0.0
7473,Strange Powers: Stephin Merritt and the Magnetic Fields,68719,68719,0,2010,1.0,0.0
7474,Bundy,68716,6073,62643,2002,0.08837825251760871,0.9116217474823913
7475,Noma: My Perfect Storm,68622,21130,47492,2015,0.30791874326017893,0.692081256739821
7476,Take Me to the River,68598,68598,0,2014,1.0,0.0
7477,Mastizaade,68583,43403,25180,2016,0.6328536226178499,0.3671463773821501
7478,Wildflower,68577,18062,50515,2016,0.2633827668168628,0.7366172331831372
7479,Cowboys and Angels,68568,33941,34627,2004,0.49499766654999416,0.5050023334500058
7480,Outside In,68492,68492,0,2018,1.0,0.0
7481,Alive and Kicking,68485,68485,0,2017,1.0,0.0
7482,Last Year at Marienbad 2019 Re-release,68402,63425,4977,2019,0.9272389696207713,0.07276103037922868
7483,Budrus,68353,68353,0,2010,1.0,0.0
7484,2012: Time for Change,68339,68339,0,2010,1.0,0.0
7485,The Eyes of Orson Welles,68328,10253,58075,2018,0.15005561409670998,0.84994438590329
7486,10x10,68260,2263,65997,2018,0.033152651626135364,0.9668473483738647
7487,Shake Hands with the Devil: The Journey of Roméo Dallaire,68249,68249,0,2005,1.0,0.0
7488,Maidentrip,68243,68243,0,2013,1.0,0.0
7489,Le Amiche,68167,68167,0,2010,1.0,0.0
7490,¡He matado a mi marido!,68017,45777,22240,2019,0.6730229207404032,0.32697707925959685
7491,I Am Big Bird: The Caroll Spinney Story,67845,67845,0,2015,1.0,0.0
7492,The Messenger,67816,67816,0,2015,1.0,0.0
7493,Summer in the Forest,67743,45542,22201,2017,0.6722761023279158,0.3277238976720842
7494,Sanam Teri Kasam,67736,22121,45615,2016,0.32657670957836304,0.673423290421637
7495,What Alice Found,67436,67436,0,2003,1.0,0.0
7496,Beyond the Gates,67433,67433,0,2004,1.0,0.0
7497,The Greasy Strangler,67427,45878,21549,2016,0.6804099248075697,0.3195900751924303
7498,For No Good Reason,67421,67421,0,2014,1.0,0.0
7499,Making the Five Heartbeats,67415,67415,0,2018,1.0,0.0
7500,Being Frank,67343,67343,0,2019,1.0,0.0
7501,The Doctor from India,67136,67136,0,2018,1.0,0.0
7502,The Sun Behind the Clouds: Tibet's Struggle for Freedom,67095,67095,0,2010,1.0,0.0
7503,The Autobiography of Nicolae Ceausescu,67093,34023,33070,2010,0.5071020821844305,0.4928979178155694
7504,Turbo Kid,67069,67069,0,2015,1.0,0.0
7505,Side by Side,67054,58825,8229,2012,0.8772780147343932,0.12272198526560682
7506,"3100, Run and Become",66789,65524,1265,2018,0.9810597553489347,0.018940244651065294
7507,Pandora's Promise,66680,66680,0,2013,1.0,0.0
7508,Max Rose,66680,66680,0,2016,1.0,0.0
7509,Vodka Lemon,66361,66361,0,2004,1.0,0.0
7510,The Town Is Quiet,66303,66303,0,2001,1.0,0.0
7511,King Georges,66175,66175,0,2016,1.0,0.0
7512,Dancing Across Borders,66166,66166,0,2010,1.0,0.0
7513,Out in the Dark,66017,26966,39051,2013,0.4084705454655619,0.5915294545344381
7514,The Talent Given Us,65827,65827,0,2005,1.0,0.0
7515,Titanic Town,65793,65793,0,2000,1.0,0.0
7516,D-Day,65536,0,65536,2013,0.0,1.0
7517,Architects of Denial,65424,65424,0,2017,1.0,0.0
7518,Blind Shaft,65383,33272,32111,2003,0.5088784546441736,0.4911215453558264
7519,Mail Order Wife,65369,62387,2982,2005,0.9543820465358197,0.045617953464180266
7520,Sing Your Song,65310,47718,17592,2012,0.730638493339458,0.26936150666054204
7521,Mad About Mambo,65283,65283,0,2000,1.0,0.0
7522,Spooky House,65238,65238,0,2002,1.0,0.0
7523,You've Been Trumped,65220,29273,35947,2012,0.44883471327813557,0.5511652867218645
7524,One 2004 Re-release,65172,65172,0,2004,1.0,0.0
7525,An Adolescent 2005 Re-release,65171,65171,0,2005,1.0,0.0
7526,Through a Lens Darkly: Black Photographers and the Emergence of a People,65169,65169,0,2014,1.0,0.0
7527,The Lesson,65142,9045,56097,2015,0.13885051119093672,0.8611494888090633
7528,Gaudi Afternoon,65115,5858,59257,2002,0.08996391000537511,0.9100360899946249
7529,Aberdeen,65090,65090,0,2001,1.0,0.0
7530,Racing Dreams,65082,65082,0,2010,1.0,0.0
7531,Last Resort,65041,37283,27758,2001,0.5732230439261389,0.4267769560738611
7532,Toys in the Attic 2012 Re-release,64918,64918,0,2012,1.0,0.0
7533,Manolo: the Boy Who Made Shoes for Lizards,64889,60056,4833,2017,0.9255189631524604,0.07448103684753965
7534,Searching for Ingmar Bergman,64742,36686,28056,2018,0.5666491612863366,0.4333508387136635
7535,"Monrovia, Indiana",64596,63944,652,2018,0.9899064957582513,0.010093504241748714
7536,Battle of the Brides,64572,64572,0,2011,1.0,0.0
7537,Let the Fire Burn,64489,64489,0,2013,1.0,0.0
7538,Trilogy: The Weeping Meadow,64424,24966,39458,2005,0.38752638768160935,0.6124736123183907
7539,Badmaa$h Company,64398,0,64398,2010,0.0,1.0
7540,Just a Kiss,64389,64389,0,2002,1.0,0.0
7541,Rock School,64310,64310,0,2005,1.0,0.0
7542,Paulette 2015 Re-release,64125,29494,34631,2015,0.4599454191033138,0.5400545808966861
7543,Girl Asleep,64056,60289,3767,2016,0.9411920819283127,0.058807918071687275
7544,Making Waves: The Art of Cinematic Sound,63998,53144,10854,2019,0.8304009500296884,0.16959904997031158
7545,Jealousy,63946,63946,0,2014,1.0,0.0
7546,Only the Strong Survive,63778,57581,6197,2003,0.9028348333281069,0.09716516667189314
7547,Her Majesty,63652,63652,0,2004,1.0,0.0
7548,The Details,63595,63595,0,2012,1.0,0.0
7549,A Liar's Autobiography: The Untrue Story of Monty Python's Graham Chapman,63469,5102,58367,2012,0.08038570010556334,0.9196142998944367
7550,All About Eve 2000 Re-release,63463,63463,0,2000,1.0,0.0
7551,I Smile Back,63373,58738,4635,2015,0.9268615972101684,0.07313840278983164
7552,Nijinsky: The Diaries of Vaslav Nijinsky,63364,55968,7396,2002,0.8832775708604255,0.11672242913957452
7553,Trapped,63241,63241,0,2016,1.0,0.0
7554,The Last of the Unjust,63136,40563,22573,2013,0.6424702230106437,0.3575297769893563
7555,No Tears for the Dead,63063,63063,0,2014,1.0,0.0
7556,Creative Control,63014,63014,0,2016,1.0,0.0
7557,"Love, Antosha",62900,50168,12732,2019,0.7975834658187599,0.20241653418124006
7558,The Mudge Boy,62852,62852,0,2004,1.0,0.0
7559,The Gardener,62734,62734,0,2018,1.0,0.0
7560,The Swan,62716,2367,60349,2018,0.0377415651508387,0.9622584348491613
7561,Cool It,62713,62713,0,2010,1.0,0.0
7562,No Such Thing,62703,62703,0,2002,1.0,0.0
7563,A Year Without Love,62676,24381,38295,2005,0.38900057438253877,0.6109994256174612
7564,Drunk Stoned Brilliant Dead,62660,62660,0,2015,1.0,0.0
7565,The Tiger Hunter,62398,62398,0,2017,1.0,0.0
7566,Mifune: The Last Samurai,62279,62279,0,2016,1.0,0.0
7567,Public Speaking,62173,62173,0,2011,1.0,0.0
7568,Proteus,62031,62031,0,2004,1.0,0.0
7569,Trigun: Badlands Rumble 2011 Re-release,62027,62027,0,2011,1.0,0.0
7570,Kites The Remix,61997,41783,20214,2010,0.6739519654176815,0.3260480345823185
7571,"I, Me aur Main",61863,0,61863,2013,0.0,1.0
7572,Dark Star: HR Gigers Welt,61845,61845,0,2015,1.0,0.0
7573,In a Valley of Violence,61797,61797,0,2016,1.0,0.0
7574,If a Tree Falls: A Story of the Earth Liberation Front,61794,61794,0,2011,1.0,0.0
7575,River Runs Red,61789,9893,51896,2018,0.1601094045865769,0.8398905954134231
7576,Amour Fou,61693,13702,47991,2014,0.22209975199779552,0.7779002480022045
7577,Quill: The Life of a Guide Dog 2012 Re-release,61674,15674,46000,2012,0.2541427505918215,0.7458572494081784
7578,Backwards,61465,61465,0,2012,1.0,0.0
7579,Donald Cried,61406,61406,0,2017,1.0,0.0
7580,Here and Now,61271,13892,47379,2018,0.22673042711886537,0.7732695728811346
7581,Never Goin' Back,61271,61271,0,2018,1.0,0.0
7582,The Seasons In Quincy: Four Portraits of John Berger,61267,28456,32811,2016,0.46445884407592997,0.53554115592407
7583,The Outcasts,61250,1455,59795,2017,0.023755102040816326,0.9762448979591837
7584,The Untamed,61249,27593,33656,2017,0.45050531437247954,0.5494946856275205
7585,Judy Berlin,61236,61236,0,2000,1.0,0.0
7586,The Mountain,61035,61035,0,2019,1.0,0.0
7587,The Bodyguard 2012 Re-release,61020,61020,0,2012,1.0,0.0
7588,Independent Lens: Don't Stop Believin': Everyman's Journey,61018,61018,0,2013,1.0,0.0
7589,The Sacrifice 2017 Re-release,61018,61018,0,2017,1.0,0.0
7590,Love U... Mr. Kalakaar!,60956,48557,12399,2011,0.7965909836603452,0.20340901633965483
7591,Chelsea Walls,60902,60902,0,2002,1.0,0.0
7592,The Wicker Man 2013 Re-release,60891,60891,0,2013,1.0,0.0
7593,It's a Disaster,60818,60818,0,2013,1.0,0.0
7594,You I Love,60815,60815,0,2004,1.0,0.0
7595,A Kid Like Jake,60784,58403,2381,2018,0.9608285075019742,0.039171492498025796
7596,Apprentice,60752,2578,58174,2016,0.042434816960758494,0.9575651830392415
7597,How to Live Forever,60630,60630,0,2011,1.0,0.0
7598,Viper Club,60607,60607,0,2018,1.0,0.0
7599,Too Late,60438,60438,0,2016,1.0,0.0
7600,Limelight,60335,60335,0,2011,1.0,0.0
7601,Crime After Crime,60291,60291,0,2011,1.0,0.0
7602,Edvard Munch,60244,43539,16705,2005,0.7227109753668415,0.27728902463315847
7603,Ikiru,60239,60239,0,2002,1.0,0.0
7604,Wetlands 2014 Re-release,60230,59478,752,2014,0.9875145276440312,0.012485472355968787
7605,Presenting Princess Shaw,60197,60197,0,2016,1.0,0.0
7606,Just One Drop,60078,60078,0,2017,1.0,0.0
7607,Gregory Crewdson: Brief Encounters,60064,60064,0,2012,1.0,0.0
7608,Decoding Annie Parker,60048,48390,11658,2014,0.8058553157474021,0.19414468425259793
7609,Down and Out with the Dolls,60000,60000,0,2003,1.0,0.0
7610,The Force,59912,59912,0,2017,1.0,0.0
7611,John Fogerty: 50 Year Trip - Live at Red Rocks,59795,59795,0,2019,1.0,0.0
7612,Frontera,59696,59696,0,2014,1.0,0.0
7613,Cheap Thrills,59424,59424,0,2014,1.0,0.0
7614,The Extraordinary Voyage,59424,52986,6438,2012,0.8916599353796446,0.1083400646203554
7615,Sweet Dreams,59403,59403,0,2013,1.0,0.0
7616,Bomb City,59329,59329,0,2018,1.0,0.0
7617,Bang! The Bert Berns Story,59299,59299,0,2017,1.0,0.0
7618,The Young Unknowns,59166,59166,0,2003,1.0,0.0
7619,Digimon Adventure tri. Part 4: Loss,59114,59114,0,2018,1.0,0.0
7620,The Trials of Muhammad Ali,59081,59081,0,2013,1.0,0.0
7621,Screen Door Jesus,59000,59000,0,2005,1.0,0.0
7622,The One I Wrote for You,58872,58872,0,2014,1.0,0.0
7623,Sagrada: The Mystery of Creation 2014 Re-release,58755,58755,0,2014,1.0,0.0
7624,The Conformist 2014 Re-release,58657,58657,0,2014,1.0,0.0
7625,Horn from the Heart: The Paul Butterfield Story,58597,58597,0,2018,1.0,0.0
7626,Putty Hill,58585,49918,8667,2011,0.852061107792097,0.14793889220790304
7627,Eyes Without a Face,58565,58565,0,2003,1.0,0.0
7628,Home Delivery,58499,58499,0,2005,1.0,0.0
7629,Gozu,58202,58202,0,2004,1.0,0.0
7630,Orlando 2010 Re-release,58198,58198,0,2010,1.0,0.0
7631,Cynthia,58177,58177,0,2018,1.0,0.0
7632,Faust,58132,58132,0,2013,1.0,0.0
7633,In Search of Greatness,58090,58090,0,2018,1.0,0.0
7634,Voices of Iraq,57999,57999,0,2004,1.0,0.0
7635,The Boom,57962,57962,0,2017,1.0,0.0
7636,Springtime in a Small Town,57751,43017,14734,2003,0.7448702186975117,0.25512978130248826
7637,Rififi 2015 Re-release,57749,57749,0,2015,1.0,0.0
7638,Command and Control,57635,57635,0,2016,1.0,0.0
7639,Battleship Potemkin,57620,51198,6422,2011,0.888545643873655,0.11145435612634502
7640,Playback,57587,264,57323,2012,0.00458436799972216,0.9954156320002778
7641,Sold,57527,57527,0,2016,1.0,0.0
7642,Court,57416,22898,34518,2015,0.39880869444057404,0.6011913055594259
7643,Ramen Heads,57345,57345,0,2018,1.0,0.0
7644,Run & Jump,57189,20061,37128,2014,0.3507842417248072,0.6492157582751927
7645,Kuch Khatti Kuch Meethi,57188,57188,0,2001,1.0,0.0
7646,Così ridevano,57009,57009,0,2001,1.0,0.0
7647,Wall,56866,14541,42325,2004,0.2557063974958675,0.7442936025041326
7648,My Joy,56857,6298,50559,2011,0.11076912253548375,0.8892308774645162
7649,The Battle of Algiers 2016 Re-release,56853,56853,0,2016,1.0,0.0
7650,Electric Shadows,56809,7129,49680,2005,0.12549067929377386,0.8745093207062261
7651,Harvard Man,56653,56653,0,2002,1.0,0.0
7652,Farmageddon,56573,56573,0,2011,1.0,0.0
7653,The Two of Us,56558,56558,0,2005,1.0,0.0
7654,Muran,56493,30116,26377,2011,0.5330925955428106,0.46690740445718937
7655,Beyond the Black Rainbow,56491,56491,0,2012,1.0,0.0
7656,Big Men,56286,56286,0,2014,1.0,0.0
7657,Saving Brinton,56218,56218,0,2017,1.0,0.0
7658,Divan,56214,56214,0,2004,1.0,0.0
7659,Wedding Doll,56196,56196,0,2016,1.0,0.0
7660,Notebook,56166,0,56166,2019,0.0,1.0
7661,False Confessions,56165,29245,26920,2017,0.5206979435591561,0.47930205644084395
7662,Kart Racer,56146,56146,0,2003,1.0,0.0
7663,Évolution,55985,24770,31215,2016,0.4424399392694472,0.5575600607305529
7664,Unknown Pleasures,55901,11254,44647,2003,0.20132019105203844,0.7986798089479615
7665,Terms and Conditions May Apply,55824,55824,0,2013,1.0,0.0
7666,Hellion,55708,55708,0,2014,1.0,0.0
7667,XX,55668,30911,24757,2017,0.5552741251706546,0.4447258748293454
7668,Holidays,55621,0,55621,2016,0.0,1.0
7669,As Good as Dead,55618,1981,53637,2010,0.03561796540688266,0.9643820345931173
7670,Finding Joe,55518,55518,0,2011,1.0,0.0
7671,Entertainment,55506,55506,0,2015,1.0,0.0
7672,The Other Side of the Street,55459,55459,0,2005,1.0,0.0
7673,Naam Shabana,55429,0,55429,2017,0.0,1.0
7674,Into Eternity,55366,55366,0,2011,1.0,0.0
7675,Dracula: Pages from a Virgin's Diary,55365,55365,0,2003,1.0,0.0
7676,C.O.G.,55301,55301,0,2013,1.0,0.0
7677,Natural Selection,55282,55282,0,2012,1.0,0.0
7678,The Tracker 2004 Re-release,55188,55188,0,2004,1.0,0.0
7679,Mamma Mia! 2018 Re-release,55168,39601,15567,2018,0.7178255510440835,0.2821744489559165
7680,American Dream: Detroit,55092,55092,0,2018,1.0,0.0
7681,The Lovely Month of May,55038,55038,0,2013,1.0,0.0
7682,Twenty Two 2017 Re-release,55001,46796,8205,2017,0.8508208941655606,0.14917910583443938
7683,Zombeavers,54985,14947,40038,2014,0.27183777393834685,0.7281622260616532
7684,Ciao America,54965,54965,0,2002,1.0,0.0
7685,DAZN Boxing: Canelo Alvarez vs. Rocky Fielding,54916,54916,0,2018,1.0,0.0
7686,Snowmen,54805,54805,0,2011,1.0,0.0
7687,Once in the Life,54780,54780,0,2000,1.0,0.0
7688,Orphans,54754,54754,0,2000,1.0,0.0
7689,The Nature of Existence,54645,54645,0,2010,1.0,0.0
7690,What Our Fathers Did: A Nazi Legacy,54603,40119,14484,2015,0.734739849458821,0.2652601505411791
7691,Grand Champion,54579,54579,0,2004,1.0,0.0
7692,The Lottery,54543,54543,0,2010,1.0,0.0
7693,The Harimaya Bridge,54473,54473,0,2010,1.0,0.0
7694,Schizo,54357,54357,0,2005,1.0,0.0
7695,Digimon Adventure tri. Part 6: Future,54324,54324,0,2018,1.0,0.0
7696,Harlan: In the Shadow of Jew Suess,54305,54305,0,2010,1.0,0.0
7697,The Search for General Tso,54275,54275,0,2015,1.0,0.0
7698,Wagner & Me 2012 Re-release,54215,37745,16470,2012,0.6962095361062437,0.30379046389375636
7699,Line of Duty,54204,54204,0,2013,1.0,0.0
7700,Jungle,54125,54125,0,2000,1.0,0.0
7701,Last Passenger,54110,14806,39304,2014,0.2736277952319349,0.7263722047680651
7702,Low Down,54051,54051,0,2014,1.0,0.0
7703,A Beautiful Soul,54008,54008,0,2012,1.0,0.0
7704,L.A. Twister,54000,54000,0,2004,1.0,0.0
7705,Surviving Progress,53953,53953,0,2012,1.0,0.0
7706,The Assassin's Code,53940,11218,42722,2018,0.20797182054134222,0.7920281794586578
7707,The Last Man on the Moon,53881,52482,1399,2016,0.9740353742506634,0.0259646257493365
7708,The Summer of Sangaile,53843,4480,49363,2015,0.0832048734283008,0.9167951265716991
7709,At Middleton,53837,53837,0,2014,1.0,0.0
7710,Easy,53825,21589,32236,2004,0.40109614491407336,0.5989038550859266
7711,Rising from Ashes,53804,38602,15202,2013,0.7174559512303917,0.2825440487696082
7712,The Heir Apparent: Largo Winch 2011 Re-release,53793,10352,43441,2011,0.1924413957206328,0.8075586042793672
7713,Down by Love,53780,675,53105,2016,0.012551134250650799,0.9874488657493492
7714,The Legend of Hallowaiian,53738,451,53287,2018,0.00839257136476981,0.9916074286352302
7715,The Other F Word,53714,53714,0,2011,1.0,0.0
7716,Leonie 2013 Re-release,53692,53692,0,2013,1.0,0.0
7717,Grass,53503,8084,45419,2018,0.15109433115900042,0.8489056688409996
7718,God of Vampires,53345,53345,0,2010,1.0,0.0
7719,Boys Life 4: Four Play,53169,53169,0,2003,1.0,0.0
7720,The Great Silence,53074,53074,0,2018,1.0,0.0
7721,Waiting for Happiness,53048,7406,45642,2003,0.1396094103453476,0.8603905896546524
7722,Love Thy Nature,52947,41149,11798,2015,0.7771733998149093,0.22282660018509076
7723,Ping Pong Summer,52909,52909,0,2014,1.0,0.0
7724,Mia and the Migoo 2010 Re-release,52873,17000,35873,2010,0.3215251640723999,0.6784748359276
7725,To Be Takei,52823,52823,0,2014,1.0,0.0
7726,Occupy Unmasked,52768,52768,0,2012,1.0,0.0
7727,!Women Art Revolution,52681,52681,0,2011,1.0,0.0
7728,Salvation Army,52511,3929,48582,2014,0.07482241816000457,0.9251775818399954
7729,Cropsey,52476,52476,0,2010,1.0,0.0
7730,Hush!,52462,21278,31184,2002,0.4055888071365941,0.5944111928634059
7731,Going Attractions: The Definitive Story of the American Drive-in Movie,52458,52458,0,2013,1.0,0.0
7732,A Tale of Winter,52431,23268,29163,2014,0.4437832579962236,0.5562167420037764
7733,Breath Made Visible: Anna Halprin,52387,52387,0,2010,1.0,0.0
7734,Birdboy: The Forgotten Children,52366,38786,13580,2017,0.7406714280258183,0.25932857197418174
7735,Here and There,52307,27156,25151,2010,0.5191656948400788,0.48083430515992126
7736,The Human Experience,52296,52296,0,2010,1.0,0.0
7737,In My Skin,52231,31046,21185,2002,0.5943979628955984,0.4056020371044016
7738,Henri-Georges Clouzot's Inferno,52003,25489,26514,2010,0.4901447993384997,0.5098552006615003
7739,Herod's Law,52000,52000,0,2003,1.0,0.0
7740,Hiding and Seeking: Faith and Tolerance After the Holocaust,51936,51936,0,2004,1.0,0.0
7741,Quay,51858,51858,0,2015,1.0,0.0
7742,The Snowman Trek,51743,51743,0,2018,1.0,0.0
7743,Wanda 2018 Re-release,51713,51713,0,2018,1.0,0.0
7744,Midnight Family,51712,42310,9402,2019,0.8181853341584159,0.18181466584158415
7745,The Fire and the Rain,51549,51549,0,2002,1.0,0.0
7746,Tickling Giants,51499,51499,0,2017,1.0,0.0
7747,The Yes Men Are Revolting,51331,50190,1141,2015,0.9777717168962226,0.022228283103777443
7748,Venus and Serena,51271,51271,0,2013,1.0,0.0
7749,God's Sandbox,51246,51246,0,2005,1.0,0.0
7750,God Loves Uganda,51229,51229,0,2013,1.0,0.0
7751,A Matter of Taste,51148,10720,40428,2001,0.2095878626730273,0.7904121373269727
7752,An Invisible Sign,51138,1279,49859,2011,0.02501075521138879,0.9749892447886112
7753,Da wan,51059,820,50239,2002,0.01605985232769933,0.9839401476723006
7754,Wasabi Tuna 2005 Re-release,51036,51036,0,2005,1.0,0.0
7755,The Unknowns,51035,51035,0,2016,1.0,0.0
7756,The Good Doctor,51017,5206,45811,2012,0.10204441656702667,0.8979555834329733
7757,As I Open My Eyes,50721,30989,19732,2016,0.6109698152638946,0.38903018473610534
7758,Long Night's Journey Into Day,50715,50715,0,2000,1.0,0.0
7759,Asambhav,50611,19504,31107,2004,0.38537076920037144,0.6146292307996285
7760,Keep Quiet,50451,50451,0,2017,1.0,0.0
7761,Clinton Road,50400,50400,0,2019,1.0,0.0
7762,Wake in Fright 2012 Re-release,50394,50394,0,2012,1.0,0.0
7763,Midnight Traveler,50336,41265,9071,2019,0.8197910044500953,0.18020899554990463
7764,The Fitzgerald Family Christmas,50292,50292,0,2012,1.0,0.0
7765,The Royal Wedding: Prince Harry and Meghan Markle,50264,50264,0,2018,1.0,0.0
7766,The Retrieval,50257,50257,0,2014,1.0,0.0
7767,The Warrior 2005 Re-release,50257,50257,0,2005,1.0,0.0
7768,You'll Get Over It,50256,50256,0,2004,1.0,0.0
7769,In Order of Disappearance 2016 Re-release,50251,50251,0,2016,1.0,0.0
7770,A Family Affair,50075,50075,0,2003,1.0,0.0
7771,Quest,50022,47807,2215,2017,0.955719483427292,0.04428051657270801
7772,The Discoverers,50020,50020,0,2014,1.0,0.0
7773,Bigger,49997,46382,3615,2018,0.9276956617397044,0.07230433826029561
7774,AKA,49988,49988,0,2003,1.0,0.0
7775,Spring,49970,49970,0,2015,1.0,0.0
7776,On the Outs,49940,49940,0,2005,1.0,0.0
7777,How to Kill Your Neighbor's Dog,49894,49894,0,2002,1.0,0.0
7778,Free Trip to Egypt,49693,49693,0,2019,1.0,0.0
7779,The Fantasticks,49666,49666,0,2000,1.0,0.0
7780,NOW: In the Wings on a World Stage,49591,49591,0,2014,1.0,0.0
7781,Red Herring,49480,49480,0,2015,1.0,0.0
7782,GasLand,49428,30846,18582,2010,0.6240592376790484,0.3759407623209517
7783,Eureka,49388,49388,0,2001,1.0,0.0
7784,Jumanji/Jumanji: Welcome to the Jungle 2018 NCM Fathom Event,49381,49381,0,2018,1.0,0.0
7785,Shirin in Love,49254,49254,0,2014,1.0,0.0
7786,Confusion of Genders 2003 Re-release,49237,49237,0,2003,1.0,0.0
7787,The Amati Girls,49136,49136,0,2001,1.0,0.0
7788,Bonsai,49128,21267,27861,2012,0.4328895945285784,0.5671104054714216
7789,Assisted Living,49048,49048,0,2005,1.0,0.0
7790,Hal,49045,48698,347,2018,0.9929248649199715,0.007075135080028545
7791,Raging Bull 25th Anniversary,49034,49034,0,2005,1.0,0.0
7792,Orgasm Inc.,49001,49001,0,2011,1.0,0.0
7793,Chocolate: Deep Dark Secrets,49000,49000,0,2005,1.0,0.0
7794,Lucky Them,48995,48995,0,2014,1.0,0.0
7795,The Internet's Own Boy: The Story of Aaron Swartz,48911,48911,0,2014,1.0,0.0
7796,Bolivar Is Me,48911,48911,0,2002,1.0,0.0
7797,The Seven Five,48869,48869,0,2015,1.0,0.0
7798,The Bounty Killer,48815,48815,0,2019,1.0,0.0
7799,A Thousand Clouds of Peace,48782,48782,0,2004,1.0,0.0
7800,The Citizen,48767,24296,24471,2013,0.49820575389095084,0.5017942461090491
7801,A Birder's Guide to Everything,48713,48713,0,2014,1.0,0.0
7802,American Mustang,48700,48700,0,2014,1.0,0.0
7803,Tales from Earthsea 2010 Re-release,48658,48658,0,2010,1.0,0.0
7804,The China Hustle,48650,48650,0,2018,1.0,0.0
7805,Person to Person,48499,48499,0,2017,1.0,0.0
7806,Alleluia,48426,6334,42092,2014,0.13079750547226696,0.869202494527733
7807,Boogie Woogie,48411,2618,45793,2010,0.05407861849579641,0.9459213815042036
7808,"Lebanon, Pa.",48381,48381,0,2011,1.0,0.0
7809,Waydowntown,48333,48333,0,2000,1.0,0.0
7810,Ceremony,48174,22270,25904,2011,0.4622825590567526,0.5377174409432474
7811,The Forbidden Room,48082,34404,13678,2015,0.7155276402811863,0.2844723597188137
7812,Interview with the Assassin,48058,48058,0,2002,1.0,0.0
7813,Life Happens,48041,30905,17136,2012,0.6433046772548449,0.3566953227451552
7814,A Cop,48040,48040,0,2013,1.0,0.0
7815,Blackball 2005 Re-release,48000,48000,0,2005,1.0,0.0
7816,Saving Banksy,47965,47965,0,2017,1.0,0.0
7817,The Queen,47818,47818,0,2019,1.0,0.0
7818,Alphaville,47696,47696,0,2014,1.0,0.0
7819,So B. It,47627,47627,0,2017,1.0,0.0
7820,GMO OMG,47558,47558,0,2013,1.0,0.0
7821,350 Days - Legends. Champions. Survivors,47526,47526,0,2018,1.0,0.0
7822,Entre les Bras,47439,47439,0,2012,1.0,0.0
7823,Twist,47370,47370,0,2004,1.0,0.0
7824,Alabama Moon,47305,47305,0,2011,1.0,0.0
7825,Daughters of the Dust 2016 Re-release,47287,40986,6301,2016,0.8667498466809059,0.13325015331909404
7826,The Raft,47269,39678,7591,2019,0.8394084918233937,0.16059150817660622
7827,Every Man for Himself,47262,47262,0,2010,1.0,0.0
7828,Never Been Thawed,47219,47219,0,2005,1.0,0.0
7829,Went the Day Well?,47214,47214,0,2011,1.0,0.0
7830,The Goebbels Experiment,47211,47211,0,2005,1.0,0.0
7831,Ivans xtc.,47027,47027,0,2002,1.0,0.0
7832,Diary of a Country Priest,47000,47000,0,2011,1.0,0.0
7833,A Master Builder,46874,46874,0,2014,1.0,0.0
7834,78/52: Hitchcock's Shower Scene,46838,37664,9174,2017,0.8041333959605449,0.19586660403945513
7835,"Connected: An Autoblogography About Love, Death & Technology",46782,46782,0,2011,1.0,0.0
7836,Tropical Malady,46750,46750,0,2005,1.0,0.0
7837,The Woodmans,46623,46623,0,2011,1.0,0.0
7838,Ca$h,46488,46488,0,2010,1.0,0.0
7839,Shanghai 2015 Re-release,46425,46425,0,2015,1.0,0.0
7840,Etoiles: Dancers of the Paris Opera Ballet,46412,46412,0,2002,1.0,0.0
7841,Patience,46410,15941,30469,2012,0.34348200818789054,0.6565179918121095
7842,Mediterranea,46392,22076,24316,2015,0.4758579065356096,0.5241420934643904
7843,William S. Burroughs: A Man Within,46380,46380,0,2010,1.0,0.0
7844,New Best Friend,46375,46375,0,2002,1.0,0.0
7845,The Tunnel 2005 Re-release,46296,46296,0,2005,1.0,0.0
7846,Greedy Lying Bastards,46121,45000,1121,2012,0.9756943691593851,0.024305630840614906
7847,Ballplayer: Pelotero,46109,46109,0,2012,1.0,0.0
7848,Panique,46041,46041,0,2017,1.0,0.0
7849,Every Day,46029,46029,0,2011,1.0,0.0
7850,Monk with a Camera,45938,45938,0,2014,1.0,0.0
7851,Maurice 2017 Re-release,45926,45926,0,2017,1.0,0.0
7852,Ellie Parker,45726,34410,11316,2005,0.7525259152342212,0.24747408476577876
7853,High on the Hog,45696,45696,0,2019,1.0,0.0
7854,Eddie: The Sleepwalking Cannibal,45604,1632,43972,2012,0.035786334532058595,0.9642136654679414
7855,3 Weeks in Yerevan,45536,45536,0,2016,1.0,0.0
7856,An Eye for Beauty,45513,9395,36118,2015,0.20642453804407532,0.7935754619559247
7857,Straight-Jacket,45497,45497,0,2004,1.0,0.0
7858,Mercury,45429,0,45429,2018,0.0,1.0
7859,Au Hasard Balthazar,45406,45406,0,2003,1.0,0.0
7860,Filmistaan,45406,45406,0,2014,1.0,0.0
7861,Return to the Hiding Place,45405,45405,0,2014,1.0,0.0
7862,Dhadkan,45380,45380,0,2000,1.0,0.0
7863,Sympathy for Mr. Vengeance 2005 Re-release,45289,45289,0,2005,1.0,0.0
7864,Ai Weiwei: The Fake Case,45255,45255,0,2014,1.0,0.0
7865,There's No Place Like Utopia,45254,45254,0,2014,1.0,0.0
7866,Karobaar: The Business of Love,45200,45200,0,2000,1.0,0.0
7867,CornerStore,45176,45176,0,2011,1.0,0.0
7868,American Made Movie,45175,45175,0,2013,1.0,0.0
7869,The Proposal,45149,45149,0,2019,1.0,0.0
7870,Bailey's Billion$,45000,45000,0,2005,1.0,0.0
7871,The Farthest,44921,14773,30148,2017,0.32886623182921126,0.6711337681707887
7872,Celebration,44898,22557,22341,2019,0.5024054523586797,0.49759454764132033
7873,The Pruitt-Igoe Myth,44883,44883,0,2012,1.0,0.0
7874,River of Fundament,44840,44840,0,2015,1.0,0.0
7875,Union Square,44830,44830,0,2012,1.0,0.0
7876,That Summer,44659,34556,10103,2018,0.7737746031035178,0.22622539689648224
7877,The Dog,44581,44581,0,2014,1.0,0.0
7878,The Bride Wore Black,44566,44566,0,2011,1.0,0.0
7879,What Is Democracy?,44536,44536,0,2019,1.0,0.0
7880,"Léon Morin, Priest 2017 Re-release",44511,44511,0,2017,1.0,0.0
7881,Defendor,44462,44462,0,2010,1.0,0.0
7882,William Eggleston in the Real World,44435,44435,0,2005,1.0,0.0
7883,Maze 2019 Re-release,44381,44381,0,2019,1.0,0.0
7884,Such a Long Journey,44364,44364,0,2000,1.0,0.0
7885,What You Gonna Do When the World's on Fire?,44290,4672,39618,2019,0.10548656581621134,0.8945134341837887
7886,Lana's Rain,44287,44287,0,2004,1.0,0.0
7887,Carmine Street Guitars,44253,44253,0,2019,1.0,0.0
7888,Slut in a Good Way,44240,40513,3727,2019,0.915754972875226,0.08424502712477396
7889,Nuts!,44230,44230,0,2016,1.0,0.0
7890,Danny Says,44213,44213,0,2016,1.0,0.0
7891,Life of a King,44161,6547,37614,2014,0.14825298340164397,0.851747016598356
7892,Hermia & Helena,44156,43152,1004,2017,0.9772624331914123,0.022737566808587736
7893,Apaharan,44133,44133,0,2005,1.0,0.0
7894,Submission,44069,39985,4084,2018,0.9073271460663959,0.09267285393360412
7895,Liyana,44045,44045,0,2018,1.0,0.0
7896,Garry Winogrand: All Things are Photographable,44002,44002,0,2018,1.0,0.0
7897,Granito,43942,43942,0,2011,1.0,0.0
7898,The Circle,43918,43918,0,2001,1.0,0.0
7899,Summer 2011 Re-release,43839,43839,0,2011,1.0,0.0
7900,Animal Factory,43805,43805,0,2000,1.0,0.0
7901,Hitler's Hollywood,43766,43766,0,2018,1.0,0.0
7902,Contempt 2013 Re-release,43763,43763,0,2013,1.0,0.0
7903,Bad Blood 2013 Re-release,43758,35176,8582,2013,0.8038758626993922,0.19612413730060788
7904,The Land,43756,43756,0,2016,1.0,0.0
7905,Bereavement,43712,43712,0,2011,1.0,0.0
7906,Woodshock,43682,42603,1079,2017,0.9752987500572318,0.024701249942768188
7907,A Grin Without A Cat,43616,43616,0,2002,1.0,0.0
7908,"February 15, 1839",43595,43595,0,2001,1.0,0.0
7909,Love Etc.,43593,43593,0,2011,1.0,0.0
7910,"OC87: The Obsessive Compulsive, Major Depression, Bipolar, Asperger's Movie",43583,43583,0,2012,1.0,0.0
7911,The Graduate 45th Anniversary Reunion,43466,43466,0,2012,1.0,0.0
7912,If You Build It,43393,43393,0,2014,1.0,0.0
7913,The Empire of Corpses,43320,0,43320,2016,0.0,1.0
7914,Next Goal Wins,43089,43089,0,2014,1.0,0.0
7915,3 Backyards,43073,43073,0,2011,1.0,0.0
7916,Jenny's Wedding,42927,4704,38223,2015,0.10958138234677475,0.8904186176532253
7917,Hadh Kar Di Aapne,42914,42914,0,2000,1.0,0.0
7918,Tell Them Who You Are,42908,39075,3833,2005,0.9106693390509928,0.08933066094900718
7919,Andre Gregory: Before and After Dinner,42892,42892,0,2013,1.0,0.0
7920,First We Take Brooklyn,42812,42812,0,2018,1.0,0.0
7921,La petite Lili 2004 Re-release,42628,34634,7994,2004,0.812470676550624,0.187529323449376
7922,Interior. Leather Bar.,42534,42534,0,2014,1.0,0.0
7923,Bolivia,42451,33098,9353,2002,0.7796753904501661,0.22032460954983393
7924,Last Call at the Oasis,42423,42423,0,2012,1.0,0.0
7925,Fixing the Future,42393,42393,0,2012,1.0,0.0
7926,Secret Lives: Hidden Children and Their Rescuers During WWII,42390,42390,0,2003,1.0,0.0
7927,Closet Monster,42360,42166,194,2016,0.9954202077431539,0.004579792256846081
7928,The Oath,42273,42273,0,2010,1.0,0.0
7929,Girlhood,42213,37977,4236,2003,0.8996517660436358,0.10034823395636415
7930,Death of a Dynasty,42108,42108,0,2005,1.0,0.0
7931,Our Time,42107,14777,27330,2019,0.3509392737549576,0.6490607262450424
7932,Down for Life,41914,41914,0,2011,1.0,0.0
7933,In Pursuit of Silence,41913,29834,12079,2016,0.7118077923317347,0.2881922076682652
7934,Golden Exits,41888,41888,0,2018,1.0,0.0
7935,The Nightmare,41853,28281,13572,2015,0.675722170453731,0.3242778295462691
7936,On the Bowery,41802,41802,0,2010,1.0,0.0
7937,Blackboards,41772,23520,18252,2002,0.5630565929330652,0.4369434070669348
7938,The Road Within,41760,0,41760,2015,0.0,1.0
7939,Adored,41703,41703,0,2004,1.0,0.0
7940,Union,41656,41656,0,2019,1.0,0.0
7941,Kalakalappu,41624,30949,10675,2012,0.7435373822794542,0.25646261772054585
7942,Death of a Superhero,41575,607,40968,2012,0.014600120264582081,0.9853998797354179
7943,The Settlers,41562,41562,0,2017,1.0,0.0
7944,Jonathan,41558,0,41558,2018,0.0,1.0
7945,Holla II,41537,41537,0,2013,1.0,0.0
7946,My Mother's Smile 2005 Re-release,41432,41432,0,2005,1.0,0.0
7947,Censored Voices,41260,41260,0,2015,1.0,0.0
7948,Steve McQueen: The Man & Le Mans,41203,6843,34360,2015,0.16608013979564595,0.833919860204354
7949,Vlad,41176,0,41176,2004,0.0,1.0
7950,The Comedy,41113,41113,0,2012,1.0,0.0
7951,Karl Marx City,41072,41072,0,2017,1.0,0.0
7952,Blue Iguana,41050,0,41050,2018,0.0,1.0
7953,The Myth of the American Sleepover,41045,41045,0,2011,1.0,0.0
7954,Fat Kid Rules the World,41000,41000,0,2012,1.0,0.0
7955,Why Don't You Just Die!,40995,0,40995,2019,0.0,1.0
7956,Hell and Back Again,40949,40634,315,2011,0.9923075044567633,0.007692495543236709
7957,Tom Dowd & the Language of Music,40919,40919,0,2004,1.0,0.0
7958,Simon Magus,40861,40861,0,2001,1.0,0.0
7959,The Intruder,40853,40853,0,2005,1.0,0.0
7960,Hate Crime,40758,40758,0,2005,1.0,0.0
7961,Found Memories,40729,10575,30154,2012,0.25964300621179015,0.7403569937882098
7962,Shikari,40712,40712,0,2000,1.0,0.0
7963,Language of a Broken Heart,40645,40645,0,2013,1.0,0.0
7964,Mercedes Sosa: The Voice of Latin America,40643,2648,37995,2013,0.06515267081662279,0.9348473291833772
7965,Life and Nothing More,40581,24358,16223,2017,0.6002316354944432,0.3997683645055568
7966,Tying the Knot,40576,40576,0,2004,1.0,0.0
7967,My Flesh and Blood,40573,40573,0,2003,1.0,0.0
7968,The FP,40557,40557,0,2012,1.0,0.0
7969,Sex Is Comedy 2004 Re-release,40470,40470,0,2004,1.0,0.0
7970,CBGB,40400,40400,0,2013,1.0,0.0
7971,Terkel in Trouble 2010 Re-release,40385,40385,0,2010,1.0,0.0
7972,Committed,40361,40361,0,2000,1.0,0.0
7973,Zizek!,40331,20177,20154,2005,0.5002851404626714,0.4997148595373286
7974,Of Mind and Music,40322,15073,25249,2016,0.37381578294727447,0.6261842170527255
7975,Paan Singh Tomar,40311,40311,0,2012,1.0,0.0
7976,The Red Baron 2010 Re-release,40239,37189,3050,2010,0.9242028877457193,0.07579711225428068
7977,Teenage,40169,40169,0,2014,1.0,0.0
7978,On Her Shoulders,40145,28288,11857,2018,0.7046456594843692,0.29535434051563086
7979,Aniara,40124,40124,0,2019,1.0,0.0
7980,Margaret Cho: Assassin,40123,40123,0,2005,1.0,0.0
7981,Addiction Incorporated,40106,40106,0,2011,1.0,0.0
7982,Humor Me,40099,40099,0,2018,1.0,0.0
7983,Unrest,40081,40081,0,2017,1.0,0.0
7984,Ghost River 2004 Re-release,40029,40029,0,2004,1.0,0.0
7985,Louder Than a Bomb,40000,40000,0,2011,1.0,0.0
7986,Is That a Gun in Your Pocket?,39928,39928,0,2016,1.0,0.0
7987,Justice,39895,39895,0,2004,1.0,0.0
7988,The Short Game,39819,39819,0,2013,1.0,0.0
7989,Plot for Peace,39811,7051,32760,2013,0.17711185350782446,0.8228881464921756
7990,Freeze Frame,39663,1100,38563,2004,0.027733656052240124,0.9722663439477599
7991,Port of Shadows,39623,27389,12234,2012,0.6912399364005755,0.3087600635994246
7992,An Elephant Sitting Still,39599,32556,7043,2018,0.8221419732821535,0.17785802671784642
7993,Belle de Jour 2017 Re-release,39551,26331,13220,2017,0.6657480215418068,0.3342519784581932
7994,The Homeless Billionaire,39493,39493,0,2016,1.0,0.0
7995,Power Trip,39359,39359,0,2003,1.0,0.0
7996,Prophet's Prey,39347,39347,0,2015,1.0,0.0
7997,Child of God,39324,39324,0,2014,1.0,0.0
7998,"3 1/2 Minutes, 10 Bullets",39263,30407,8856,2015,0.7744441331533505,0.22555586684664952
7999,La Notte,39236,39236,0,2016,1.0,0.0
8000,Where Soldiers Come From,39201,39201,0,2011,1.0,0.0
8001,How to Make Money Selling Drugs,39192,39192,0,2013,1.0,0.0
8002,I Do Not Care If We Go Down in History as Barbarians,39171,11307,27864,2018,0.2886574251359424,0.7113425748640576
8003,The Expedition to the End of the World,39115,39115,0,2014,1.0,0.0
8004,Zilla and Zoe,39003,39003,0,2019,1.0,0.0
8005,I Used to Be Darker,38974,22214,16760,2013,0.5699697234053471,0.43003027659465287
8006,Herb & Dorothy 50X50,38933,38933,0,2013,1.0,0.0
8007,Shed of the Dead,38901,38901,0,2019,1.0,0.0
8008,The Son of Joseph,38774,30588,8186,2016,0.7888791458193635,0.2111208541806365
8009,Restored Me,38745,38745,0,2016,1.0,0.0
8010,Bluebeard,38696,33490,5206,2010,0.8654641306594997,0.1345358693405003
8011,Paul Williams Still Alive,38691,38691,0,2012,1.0,0.0
8012,Catching the Sun,38613,38613,0,2016,1.0,0.0
8013,A Rumor of Angels,38610,38610,0,2002,1.0,0.0
8014,The Year of the Yao,38585,35591,2994,2005,0.9224050796941817,0.07759492030581833
8015,Spa Night,38578,38578,0,2016,1.0,0.0
8016,Troublemakers: The Story of Land Art,38571,29462,9109,2016,0.7638381167198154,0.2361618832801846
8017,Divide and Conquer,38510,38510,0,2018,1.0,0.0
8018,Death by China,38492,38492,0,2012,1.0,0.0
8019,Multiple Maniacs,38403,33036,5367,2016,0.860245293336458,0.13975470666354192
8020,Araby,38399,38399,0,2018,1.0,0.0
8021,Batman Forever 2019 Re-release,38387,38014,373,2019,0.9902831687810978,0.009716831218902232
8022,Nine Nation Animation,38382,38382,0,2010,1.0,0.0
8023,The Blackcoat's Daughter,38348,20435,17913,2017,0.5328830708250756,0.46711692917492437
8024,Policeman,38263,11263,27000,2013,0.29435747327705614,0.7056425267229438
8025,No Intenso Agora,38223,24955,13268,2018,0.6528791565287916,0.3471208434712084
8026,Shadow Hours,38181,38181,0,2000,1.0,0.0
8027,Germans & Jews,38100,38100,0,2016,1.0,0.0
8028,The Legend of Pale Male,38083,38083,0,2010,1.0,0.0
8029,All About Lily Chou-Chou,38082,26485,11597,2002,0.6954729268420776,0.3045270731579224
8030,Gray Matter,38034,38034,0,2018,1.0,0.0
8031,Moscow Never Sleeps,38004,25306,12698,2016,0.6658772760762025,0.3341227239237975
8032,Band of Outsiders 2016 Re-release,38004,38004,0,2016,1.0,0.0
8033,The Crime of Monsieur Lange,38002,36438,1564,2017,0.9588442713541393,0.04115572864586074
8034,Russian Ark 2013 Re-release,37984,37984,0,2013,1.0,0.0
8035,Bollywood/Hollywood 2003 Re-release,37962,37962,0,2003,1.0,0.0
8036,Adult World,37887,25368,12519,2014,0.6695700372159316,0.3304299627840684
8037,I Am the Blues,37849,37849,0,2017,1.0,0.0
8038,The Heart of Nuba,37788,37788,0,2018,1.0,0.0
8039,Out 1,37743,31539,6204,2015,0.835625149034258,0.164374850965742
8040,Mumia: Long Distance Revolutionary,37731,37731,0,2013,1.0,0.0
8041,Millennium Actress,37641,37641,0,2003,1.0,0.0
8042,Krystal,37516,37516,0,2018,1.0,0.0
8043,News from Planet Mars,37507,310,37197,2016,0.008265123843549204,0.9917348761564508
8044,Incident at Loch Ness,37493,37493,0,2004,1.0,0.0
8045,Big Sur,37466,37466,0,2013,1.0,0.0
8046,Match 2015 Re-release,37285,37285,0,2015,1.0,0.0
8047,Memory: The Origins of Alien,37272,31378,5894,2019,0.8418652071259927,0.1581347928740073
8048,Savannah,37240,37240,0,2013,1.0,0.0
8049,This Thing of Ours,37227,37227,0,2003,1.0,0.0
8050,Benjamin Smoke,37111,37111,0,2000,1.0,0.0
8051,Small Group,37058,37058,0,2018,1.0,0.0
8052,24 Frames,37045,34482,2563,2018,0.9308138750168714,0.06918612498312862
8053,The Quiet One,37010,37010,0,2019,1.0,0.0
8054,Pavilion of Women,36992,36992,0,2001,1.0,0.0
8055,Children of Paradise 2012 Re-release,36986,36986,0,2012,1.0,0.0
8056,Grey Gardens,36923,36923,0,2015,1.0,0.0
8057,Kurukshetra,36890,36890,0,2000,1.0,0.0
8058,Trust Fund,36885,36885,0,2016,1.0,0.0
8059,The Death of Dick Long,36856,36856,0,2019,1.0,0.0
8060,Sister Code,36676,36676,0,2015,1.0,0.0
8061,Mind Game,36613,36613,0,2018,1.0,0.0
8062,Bending the Arc,36586,21907,14679,2017,0.5987809544634559,0.40121904553654403
8063,Yoga Hosers,36585,0,36585,2016,0.0,1.0
8064,Hit So Hard,36576,34025,2551,2012,0.9302548118985127,0.06974518810148732
8065,For Those Who Don't Read Me,36506,36506,0,2018,1.0,0.0
8066,Cherry,36465,11362,25103,2010,0.31158645276292335,0.6884135472370766
8067,The Servant,36463,36463,0,2013,1.0,0.0
8068,The Umbrellas of Cherbourg,36432,28030,8402,2004,0.7693785682916118,0.23062143170838822
8069,From Here to Eternity,36416,36416,0,2003,1.0,0.0
8070,Unexpected,36402,23986,12416,2015,0.6589198395692545,0.34108016043074557
8071,How to Let Go of the World: and Love All the Things Climate Can't Change,36386,36386,0,2016,1.0,0.0
8072,Welcome to Leith,36380,36010,370,2015,0.9898295766904893,0.01017042330951072
8073,Mansome,36280,36280,0,2012,1.0,0.0
8074,Loosies,36145,3519,32626,2012,0.09735786415825148,0.9026421358417485
8075,Touchy Feely,36128,36128,0,2013,1.0,0.0
8076,Dirty Love,36099,36099,0,2005,1.0,0.0
8077,Le Corbeau,36089,36089,0,2018,1.0,0.0
8078,Jiminy Glick in Lalawood,36039,36039,0,2005,1.0,0.0
8079,Brimstone & Glory,36036,32059,3977,2017,0.8896381396381396,0.11036186036186037
8080,"Kill Me, Deadly",36027,36027,0,2016,1.0,0.0
8081,Not Cool,36026,36026,0,2014,1.0,0.0
8082,Almost Friends,35842,1481,34361,2017,0.04132023882595837,0.9586797611740416
8083,The House of Tomorrow,35821,35821,0,2018,1.0,0.0
8084,Bangkok Revenge,35784,35784,0,2012,1.0,0.0
8085,The Road Movie,35757,35757,0,2018,1.0,0.0
8086,Good Manners,35714,31177,4537,2018,0.8729629837038696,0.12703701629613037
8087,Paul Goodman Changed My Life,35671,35671,0,2011,1.0,0.0
8088,Far Out Isn't Far Enough: The Tomi Ungerer Story,35647,35647,0,2013,1.0,0.0
8089,After Freedom,35639,35639,0,2004,1.0,0.0
8090,Loro,35613,35613,0,2019,1.0,0.0
8091,M 2013 Re-release,35566,35566,0,2013,1.0,0.0
8092,Guy and Madeline on a Park Bench,35556,35556,0,2010,1.0,0.0
8093,Finders Keepers,35555,35555,0,2015,1.0,0.0
8094,The Event,35554,35554,0,2003,1.0,0.0
8095,PGS: Intuition Is Your Personal Guidance System,35423,35423,0,2018,1.0,0.0
8096,Kinyarwanda,35412,35412,0,2011,1.0,0.0
8097,Max and the Junkmen,35387,35387,0,2012,1.0,0.0
8098,Le Jour Se Leve,35321,35321,0,2014,1.0,0.0
8099,Growing Up Smith,35312,35312,0,2017,1.0,0.0
8100,The Decent One,35282,21327,13955,2014,0.6044725355705459,0.39552746442945413
8101,Underdogs,35271,35271,0,2013,1.0,0.0
8102,Rat Film,35195,35195,0,2017,1.0,0.0
8103,Ága,35178,35178,0,2019,1.0,0.0
8104,That Man from Rio,35144,35144,0,2014,1.0,0.0
8105,"Goodbye, Dragon Inn",35120,35120,0,2004,1.0,0.0
8106,When Harry Tries to Marry,35100,35100,0,2011,1.0,0.0
8107,The Girl,35048,35048,0,2013,1.0,0.0
8108,Hotel,34971,29813,5158,2003,0.8525063624145721,0.14749363758542794
8109,A Decade Under the Influence,34837,34837,0,2003,1.0,0.0
8110,Campfire,34835,34835,0,2005,1.0,0.0
8111,Beneath the Harvest Sky,34768,34768,0,2014,1.0,0.0
8112,This Ain't No Mouse Music,34754,34754,0,2014,1.0,0.0
8113,Comic-Con Episode IV: A Fan's Hope,34665,34665,0,2012,1.0,0.0
8114,The Old Dark House,34649,25678,8971,2017,0.7410892089237785,0.25891079107622156
8115,Showboy,34646,34646,0,2004,1.0,0.0
8116,Sophie and the Rising Sun,34630,34630,0,2017,1.0,0.0
8117,Le Trou,34588,34588,0,2017,1.0,0.0
8118,Orchestra of Exiles,34577,34577,0,2012,1.0,0.0
8119,Rakuen Tsuiho: Expelled from Paradise,34510,34510,0,2014,1.0,0.0
8120,Cosmos,34393,25856,8537,2015,0.7517808856453349,0.2482191143546652
8121,Pierrot le Fou 2015 Re-release,34371,34371,0,2015,1.0,0.0
8122,Holy Hell,34366,34366,0,2018,1.0,0.0
8123,Off the Rails,34249,34249,0,2016,1.0,0.0
8124,Rocks in My Pockets,34236,34236,0,2014,1.0,0.0
8125,Martin & Orloff,34222,34222,0,2003,1.0,0.0
8126,Just Like a Woman,34206,11403,22803,2013,0.3333625679705315,0.6666374320294686
8127,Dave Made a Maze,34117,34117,0,2017,1.0,0.0
8128,Beautiful Darling,34096,34096,0,2011,1.0,0.0
8129,Kilo Two Bravo,34017,7891,26126,2015,0.23197224916953288,0.7680277508304671
8130,Bert Stern: Original Madman,34005,34005,0,2013,1.0,0.0
8131,Maui,33953,33953,0,2018,1.0,0.0
8132,Killer Unicorn,33901,33901,0,2019,1.0,0.0
8133,Signs & Wonders,33842,33842,0,2001,1.0,0.0
8134,Moonlight Sonata: Deafness in Three Movements,33823,33823,0,2019,1.0,0.0
8135,It Felt Like Love,33817,33817,0,2014,1.0,0.0
8136,Closed Curtain,33735,28098,5637,2014,0.8329035126722988,0.1670964873277012
8137,Below Her Mouth,33673,0,33673,2017,0.0,1.0
8138,The Turandot Project,33504,33504,0,2001,1.0,0.0
8139,Making the Boys,33443,33443,0,2011,1.0,0.0
8140,The Winding Stream,33420,33420,0,2015,1.0,0.0
8141,Final Girl,33411,0,33411,2015,0.0,1.0
8142,"Distant Voices, Still Lives 2018 Re-release",33301,5234,28067,2018,0.15717245728356505,0.8428275427164349
8143,Running from Crazy,33300,33300,0,2013,1.0,0.0
8144,Life: A User's Manual,33236,33236,0,2001,1.0,0.0
8145,Daddy Longlegs,33217,21766,11451,2010,0.6552668814161423,0.3447331185838577
8146,Wasted! The Story of Food Waste,33211,33211,0,2017,1.0,0.0
8147,Love & Taxes,33150,33150,0,2017,1.0,0.0
8148,American Teacher,33144,33144,0,2011,1.0,0.0
8149,Super Dark Times,33109,33109,0,2017,1.0,0.0
8150,Dislecksia: The Movie,33066,33066,0,2013,1.0,0.0
8151,Meet Monica Velour,33042,33042,0,2011,1.0,0.0
8152,Ahead of Time: The Extraordinary Journey of Ruth Gruber,33024,33024,0,2010,1.0,0.0
8153,Albatross,32992,0,32992,2011,0.0,1.0
8154,Being Charlie,32964,30400,2564,2016,0.9222181774056547,0.07778182259434535
8155,Spoken Word,32961,32961,0,2010,1.0,0.0
8156,The Intervention,32919,32919,0,2016,1.0,0.0
8157,Smile,32833,32833,0,2005,1.0,0.0
8158,No Home Movie,32757,32757,0,2016,1.0,0.0
8159,L'Age d'Or,32712,32712,0,2004,1.0,0.0
8160,The Nun,32659,30245,2414,2018,0.9260846933463976,0.07391530665360238
8161,Boesman and Lena,32625,32625,0,2000,1.0,0.0
8162,Sollers Point,32608,32608,0,2018,1.0,0.0
8163,The Day I Saw Your Heart 2012 Re-release,32567,3546,29021,2012,0.10888322535081524,0.8911167746491847
8164,Spettacolo,32494,32494,0,2017,1.0,0.0
8165,Boxing Gym,32476,32476,0,2010,1.0,0.0
8166,Rurouni Kenshin Part I: Origins 2016 Re-release,32445,32445,0,2016,1.0,0.0
8167,An Acceptable Loss,32427,32427,0,2019,1.0,0.0
8168,Brotherhood,32416,19722,12694,2010,0.6084032576505429,0.39159674234945707
8169,10E,32413,32413,0,2019,1.0,0.0
8170,Beetle Queen Conquers Tokyo,32308,32308,0,2010,1.0,0.0
8171,Living in Emergency,32208,32208,0,2010,1.0,0.0
8172,The Hero of Color City,32188,32188,0,2014,1.0,0.0
8173,Goodland,32140,32140,0,2018,1.0,0.0
8174,The Weekend,32050,32050,0,2000,1.0,0.0
8175,Shooting the Mafia,32042,10881,21161,2019,0.33958554397353474,0.6604144560264653
8176,Desolation Center,32016,32016,0,2019,1.0,0.0
8177,Last Life in the Universe,32014,32014,0,2004,1.0,0.0
8178,"Rio, I Love You 2016 Re-release",31982,31982,0,2016,1.0,0.0
8179,Moynihan,31970,31970,0,2018,1.0,0.0
8180,District of Corruption,31954,31954,0,2012,1.0,0.0
8181,Reel Paradise,31918,31918,0,2005,1.0,0.0
8182,Going Shopping,31908,31908,0,2005,1.0,0.0
8183,Amira & Sam,31849,31849,0,2015,1.0,0.0
8184,Paths of the Soul,31747,31747,0,2016,1.0,0.0
8185,180° South,31745,31745,0,2010,1.0,0.0
8186,At Berkeley,31736,31736,0,2013,1.0,0.0
8187,Aurora,31720,5677,26043,2011,0.1789722572509458,0.8210277427490542
8188,Glowing Eyes,31653,31653,0,2003,1.0,0.0
8189,Gift,31588,31588,0,2019,1.0,0.0
8190,Signature Move,31551,31551,0,2017,1.0,0.0
8191,The Cat Rescuers,31540,31540,0,2019,1.0,0.0
8192,The Passionate Thief,31539,31539,0,2014,1.0,0.0
8193,Musical Chairs,31478,31478,0,2012,1.0,0.0
8194,Celine and Julie Go Boating,31452,31452,0,2012,1.0,0.0
8195,Beyond the Farthest Star,31433,31433,0,2013,1.0,0.0
8196,Here,31428,26743,4685,2012,0.8509291078019601,0.14907089219803996
8197,Fabled,31425,31425,0,2004,1.0,0.0
8198,Sidemen: Long Road to Glory,31399,31399,0,2017,1.0,0.0
8199,Mudbound,31389,0,31389,2017,0.0,1.0
8200,Don Verdean,31309,31309,0,2015,1.0,0.0
8201,Bootmen,31288,31288,0,2000,1.0,0.0
8202,The Raspberry Reich,31211,31211,0,2004,1.0,0.0
8203,Buddy,31203,31203,0,2019,1.0,0.0
8204,"Hey, Boo: Harper Lee and 'To Kill a Mockingbird'",31135,31135,0,2011,1.0,0.0
8205,Small Town Murder Songs,31133,31133,0,2011,1.0,0.0
8206,7 Witches,31100,31100,0,2017,1.0,0.0
8207,White Irish Drinkers,31056,31056,0,2011,1.0,0.0
8208,Poor Boy,31031,31031,0,2018,1.0,0.0
8209,Chooch,31015,31015,0,2004,1.0,0.0
8210,"2 Autumns, 3 Winters",30985,5819,25166,2014,0.18780054865257384,0.8121994513474262
8211,The Seventh Fire,30977,30112,865,2016,0.9720760564289634,0.027923943571036575
8212,Who Is Harry Nilsson (And Why Is Everybody Talkin' About Him?),30975,30975,0,2010,1.0,0.0
8213,Gangster No. 1,30915,30915,0,2002,1.0,0.0
8214,Sans Soleil,30878,30878,0,2003,1.0,0.0
8215,Lamb,30844,14547,16297,2016,0.47163143561146414,0.5283685643885359
8216,Meet the Fokkens,30810,30810,0,2012,1.0,0.0
8217,Pasolini 2019 Re-release,30757,30757,0,2019,1.0,0.0
8218,Under the Skin of the City,30666,30666,0,2003,1.0,0.0
8219,Documented,30662,30662,0,2014,1.0,0.0
8220,Hide Away,30655,30655,0,2012,1.0,0.0
8221,The Chaperone,30514,0,30514,2011,0.0,1.0
8222,Gang of Roses,30497,30497,0,2003,1.0,0.0
8223,The Boondock Saints,30471,30471,0,2000,1.0,0.0
8224,Los Reyes,30418,30418,0,2019,1.0,0.0
8225,Dealt,30414,30414,0,2017,1.0,0.0
8226,These Birds Walk,30408,30408,0,2013,1.0,0.0
8227,"Hare Krishna! The Mantra, the Movement and the Swami Who Started It 2017 Re-release",30380,19278,11102,2017,0.6345622119815668,0.3654377880184332
8228,The Take,30380,30380,0,2004,1.0,0.0
8229,Shanghai Red 2010 Re-release,30353,30353,0,2010,1.0,0.0
8230,Heavy Trip,30351,10153,20198,2018,0.33451945570162434,0.6654805442983757
8231,39 Pounds of Love,30330,28195,2135,2005,0.9296076491922189,0.07039235080778107
8232,Happy Christmas,30312,30312,0,2014,1.0,0.0
8233,No Greater Love,30247,30247,0,2017,1.0,0.0
8234,Down to the Bone,30241,30241,0,2005,1.0,0.0
8235,WMD: Weapons of Mass Deception,30210,30210,0,2004,1.0,0.0
8236,Cold Water,30209,30209,0,2018,1.0,0.0
8237,Army of Shadows 2015 Re-release,30190,30190,0,2015,1.0,0.0
8238,The Times of Harvey Milk,30187,13801,16386,2000,0.45718355583529335,0.5428164441647066
8239,Runoff,30186,30186,0,2015,1.0,0.0
8240,Paul Taylor: Creative Domain,30168,30168,0,2015,1.0,0.0
8241,Southern Baptist Sissies,30160,30160,0,2014,1.0,0.0
8242,In My Sleep,30158,30158,0,2010,1.0,0.0
8243,Lionel Richie at Glastonbury,30123,30123,0,2019,1.0,0.0
8244,Therapy for a Vampire 2016 Re-release,30115,30115,0,2016,1.0,0.0
8245,A Long Way Off,30104,30104,0,2014,1.0,0.0
8246,Manakamana,30029,30029,0,2014,1.0,0.0
8247,Cat Run,30000,30000,0,2011,1.0,0.0
8248,Evidence of a Haunting,29904,29904,0,2011,1.0,0.0
8249,Saint Misbehavin': The Wavy Gravy Movie,29893,29893,0,2010,1.0,0.0
8250,Praise,29874,29874,0,2000,1.0,0.0
8251,Lbs.,29866,29866,0,2010,1.0,0.0
8252,Brother 2012 Re-release,29864,29864,0,2012,1.0,0.0
8253,Long Shot: The Kevin Laue Story 2013 Re-release,29863,29863,0,2013,1.0,0.0
8254,A Fierce Green Fire: The Battle for A Living Planet,29817,29817,0,2013,1.0,0.0
8255,Uncertain,29736,29736,0,2017,1.0,0.0
8256,Multiple Sarcasms,29731,29731,0,2010,1.0,0.0
8257,Yellow Day,29656,29656,0,2014,1.0,0.0
8258,Memories of Underdevelopment 2018 Re-release,29647,29647,0,2018,1.0,0.0
8259,The Perfect Race,29644,29644,0,2019,1.0,0.0
8260,Dead Man's Burden,29634,29634,0,2013,1.0,0.0
8261,The Eyes of My Mother,29539,27099,2440,2016,0.9173973391110057,0.0826026608889942
8262,Little Fugitive 2013 Re-release,29505,29505,0,2013,1.0,0.0
8263,The Best Democracy Money Can Buy,29500,29500,0,2016,1.0,0.0
8264,The Dog Wedding,29495,29495,0,2016,1.0,0.0
8265,Redemption Road,29384,29384,0,2011,1.0,0.0
8266,Gypsy 83,29367,29367,0,2004,1.0,0.0
8267,Big Girls Don't Cry,29361,1238,28123,2003,0.04216477640407343,0.9578352235959265
8268,Empathy,29345,29345,0,2004,1.0,0.0
8269,Cousin Jules,29337,29337,0,2013,1.0,0.0
8270,Charm City,29335,29335,0,2018,1.0,0.0
8271,The Topp Twins: Untouchable Girls 2011 Re-release,29316,29316,0,2011,1.0,0.0
8272,Xenia 2015 Re-release,29274,3181,26093,2015,0.10866297738607639,0.8913370226139237
8273,Lemon,29258,29258,0,2017,1.0,0.0
8274,The Ground Beneath My Feet,29251,29251,0,2019,1.0,0.0
8275,Sinbad: Beyond the Veil of Mists,29245,29245,0,2000,1.0,0.0
8276,Time to Choose,29233,29233,0,2016,1.0,0.0
8277,Naked Fame,29220,29220,0,2005,1.0,0.0
8278,Daybreak,29081,6995,22086,2004,0.2405350572538771,0.7594649427461229
8279,Fire in the Blood,28994,28994,0,2013,1.0,0.0
8280,Othello,28980,28980,0,2014,1.0,0.0
8281,A Foreign Affair,28909,28909,0,2004,1.0,0.0
8282,Plush,28864,3080,25784,2013,0.10670731707317073,0.8932926829268293
8283,Teknolust,28811,28811,0,2003,1.0,0.0
8284,Two in the Wave,28808,28808,0,2010,1.0,0.0
8285,Batman & Robin 2019 Re-release,28793,28597,196,2019,0.9931927899142152,0.00680721008578474
8286,Rebels of the Neon God,28791,28791,0,2015,1.0,0.0
8287,Americons,28782,28782,0,2015,1.0,0.0
8288,Hearts and Minds,28754,28754,0,2004,1.0,0.0
8289,Nénette,28699,18009,10690,2010,0.627513153768424,0.372486846231576
8290,Hitler's Children,28663,28663,0,2012,1.0,0.0
8291,Band of Outsiders,28656,28656,0,2001,1.0,0.0
8292,The Transfiguration,28631,22091,6540,2017,0.771576263490622,0.22842373650937794
8293,Garbo: El espía 2011 Re-release,28563,28563,0,2011,1.0,0.0
8294,Restoring Tomorrow,28556,28556,0,2018,1.0,0.0
8295,Stations of the Elevated,28516,28516,0,2014,1.0,0.0
8296,P.S. Your Cat Is Dead!,28454,28454,0,2003,1.0,0.0
8297,Carrie Pilby,28430,18957,9473,2017,0.6667956384101301,0.3332043615898699
8298,"Rabin, the Last Day",28411,28411,0,2016,1.0,0.0
8299,The Load,28410,28410,0,2019,1.0,0.0
8300,Struck by Lightning,28378,28378,0,2013,1.0,0.0
8301,The Strange Ones,28374,0,28374,2017,0.0,1.0
8302,Southpaw,28365,28365,0,2000,1.0,0.0
8303,North Sea Texas 2012 Re-release,28307,28307,0,2012,1.0,0.0
8304,"Arabian Nights - Volume 1, The Restless One",28245,12260,15985,2015,0.43405912550893966,0.5659408744910603
8305,"Like Sunday, Like Rain",28208,28208,0,2015,1.0,0.0
8306,7 Chinese Brothers,28180,28180,0,2015,1.0,0.0
8307,Teddy Bears' Picnic,28149,28149,0,2002,1.0,0.0
8308,"South of Heaven, West of Hell",28149,28149,0,2001,1.0,0.0
8309,The Ambassador,28102,28102,0,2012,1.0,0.0
8310,Eternal,28089,28089,0,2005,1.0,0.0
8311,Bikes vs Cars,28072,28072,0,2015,1.0,0.0
8312,Sembene!,28059,28059,0,2015,1.0,0.0
8313,Take Me to the River,28041,28041,0,2016,1.0,0.0
8314,Superstar in a Housedress,28032,28032,0,2004,1.0,0.0
8315,Least Among Saints,28026,28026,0,2012,1.0,0.0
8316,Quai des Orfèvres 2018 Re-release,28013,28013,0,2018,1.0,0.0
8317,The Amendment,27961,27961,0,2018,1.0,0.0
8318,Ribbons,27959,27959,0,2017,1.0,0.0
8319,El Norte 2019 Re-release,27920,27920,0,2019,1.0,0.0
8320,King of the Jungle,27841,27841,0,2001,1.0,0.0
8321,Radio Dreams,27836,27836,0,2017,1.0,0.0
8322,Bauhaus Spirit: 100 Years of Bauhaus,27768,17122,10646,2019,0.6166090463843272,0.3833909536156727
8323,Simon Killer,27740,27740,0,2013,1.0,0.0
8324,30 Years of Garbage: The Garbage Pail Kids Story,27739,27739,0,2017,1.0,0.0
8325,Senso,27723,27723,0,2018,1.0,0.0
8326,Broadway Idiot,27595,27595,0,2013,1.0,0.0
8327,The King and the Mockingbird 2014 Re-release,27513,27513,0,2014,1.0,0.0
8328,Beyond Vanilla,27396,27396,0,2003,1.0,0.0
8329,Kate Plays Christine,27364,25564,1800,2016,0.9342201432539102,0.06577985674608976
8330,Unlocking the Cage,27284,27284,0,2016,1.0,0.0
8331,Three 2004 Re-release,27256,27256,0,2004,1.0,0.0
8332,Everybody Says I'm Fine!,27225,27225,0,2003,1.0,0.0
8333,Tiger Eyes,27160,27160,0,2013,1.0,0.0
8334,Bronx Gothic,27151,27151,0,2017,1.0,0.0
8335,"Leaving Home, Coming Home: A Portrait of Robert Frank",27073,27073,0,2019,1.0,0.0
8336,Last Weekend,27053,27053,0,2014,1.0,0.0
8337,Clash,27052,27052,0,2011,1.0,0.0
8338,Level Five,27000,27000,0,2014,1.0,0.0
8339,The Last Ride,27000,27000,0,2011,1.0,0.0
8340,Mali Blues,26950,26950,0,2017,1.0,0.0
8341,Cape of Good Hope,26904,26904,0,2005,1.0,0.0
8342,A Monster with a Thousand Heads,26865,24852,2013,2016,0.925069793411502,0.07493020658849804
8343,"The Devil, Probably",26816,26816,0,2012,1.0,0.0
8344,Fish Without a Bicycle,26799,26799,0,2004,1.0,0.0
8345,"Massoud, the Afghan 2002 Re-release",26747,26747,0,2002,1.0,0.0
8346,Tap World,26747,26747,0,2015,1.0,0.0
8347,Khiladi 420,26731,26731,0,2000,1.0,0.0
8348,Peace Officer,26632,26632,0,2015,1.0,0.0
8349,"Pink Ribbons, Inc.",26608,26608,0,2012,1.0,0.0
8350,Wrestle,26597,26597,0,2019,1.0,0.0
8351,Milford Graves Full Mantis,26566,26566,0,2018,1.0,0.0
8352,Front Cover,26409,26409,0,2016,1.0,0.0
8353,9 Dead Gay Guys,26377,26377,0,2003,1.0,0.0
8354,At First Light,26338,3292,23046,2018,0.12499050801123851,0.8750094919887614
8355,Marlina the Murderer in Four Acts,26331,17788,8543,2018,0.6755535300596255,0.32444646994037446
8356,Donnybrook,26284,26284,0,2019,1.0,0.0
8357,October Country,26185,26185,0,2010,1.0,0.0
8358,The Misandrists,26123,26123,0,2018,1.0,0.0
8359,"Sex, Politics & Cocktails",26087,26087,0,2005,1.0,0.0
8360,They Call us Monsters,26080,26080,0,2017,1.0,0.0
8361,"Lipstick & Dynamite, Piss & Vinegar: The First Ladies of Wrestling",26073,26073,0,2005,1.0,0.0
8362,Maze,26041,26041,0,2001,1.0,0.0
8363,Ridge Runners,26019,26019,0,2018,1.0,0.0
8364,Main Street,26011,2560,23451,2011,0.09841989927338433,0.9015801007266157
8365,Jet Trash 2018 Re-release,26002,26002,0,2018,1.0,0.0
8366,Black Mother,25919,18762,7157,2018,0.7238705196959759,0.27612948030402407
8367,Django,25916,25916,0,2012,1.0,0.0
8368,Cowards Bend the Knee,25860,25860,0,2004,1.0,0.0
8369,Women Like Us,25859,25859,0,2017,1.0,0.0
8370,Caesar and Otto's Summer Camp Massacre,25844,25844,0,2011,1.0,0.0
8371,Spriggan,25824,25824,0,2001,1.0,0.0
8372,Elena,25788,25788,0,2014,1.0,0.0
8373,Quitting,25717,18531,7186,2002,0.7205739394175059,0.2794260605824941
8374,Gurukulam,25651,25651,0,2016,1.0,0.0
8375,Immortality,25648,25648,0,2000,1.0,0.0
8376,Passion Play,25603,3669,21934,2011,0.14330351911885325,0.8566964808811467
8377,The Exploding Girl,25572,25572,0,2010,1.0,0.0
8378,Banjo,25531,25531,0,2016,1.0,0.0
8379,Waiting for Forever,25517,25517,0,2011,1.0,0.0
8380,Christian Mingle,25480,25480,0,2014,1.0,0.0
8381,Werckmeister Harmonies,25461,25461,0,2001,1.0,0.0
8382,Kill Command,25427,0,25427,2016,0.0,1.0
8383,Nobody Walks,25342,25342,0,2012,1.0,0.0
8384,Maestro,25315,25315,0,2004,1.0,0.0
8385,Rediscover Sautet,25314,25314,0,2015,1.0,0.0
8386,Disturbing the Peace,25287,25287,0,2016,1.0,0.0
8387,In Search of Fellini,25269,12772,12497,2017,0.5054414499980213,0.49455855000197874
8388,Death of the Virgin,25247,25247,0,2012,1.0,0.0
8389,The Worst Movie Ever!,25206,25206,0,2011,1.0,0.0
8390,Drivers Wanted,25189,25189,0,2005,1.0,0.0
8391,Fresh,25115,25115,0,2010,1.0,0.0
8392,Vazante,25091,23884,1207,2018,0.9518951018293412,0.0481048981706588
8393,Bonnie & Clyde vs. Dracula,25027,25027,0,2011,1.0,0.0
8394,The Lucky Man,25015,25015,0,2017,1.0,0.0
8395,The Power of Few,25000,25000,0,2013,1.0,0.0
8396,Shadow Glories,24997,24997,0,2001,1.0,0.0
8397,The Isle,24963,20666,4297,2002,0.827865240556023,0.17213475944397708
8398,Ugetsu,24959,11197,13762,2017,0.44861572979686687,0.5513842702031332
8399,R100,24956,24956,0,2015,1.0,0.0
8400,Rana's Wedding,24930,10604,14326,2003,0.4253509827517048,0.5746490172482952
8401,Naples '44,24863,24620,243,2017,0.9902264408961107,0.009773559103889313
8402,An Elephant's Journey,24844,24844,0,2018,1.0,0.0
8403,Madaari,24822,0,24822,2016,0.0,1.0
8404,Marius/Fanny/César,24787,24787,0,2017,1.0,0.0
8405,Paradise 2017 Re-release,24749,24749,0,2017,1.0,0.0
8406,Strike,24743,15758,8985,2019,0.6368669926847997,0.36313300731520026
8407,Cold Comes the Night,24732,16971,7761,2013,0.6861960213488598,0.31380397865114024
8408,Horses: The Story of Equus,24716,0,24716,2002,0.0,1.0
8409,The Day,24686,20984,3702,2012,0.8500364579113667,0.14996354208863324
8410,Hyenas,24672,24672,0,2019,1.0,0.0
8411,The Departure,24662,24662,0,2017,1.0,0.0
8412,Harvest,24657,24657,0,2011,1.0,0.0
8413,Knuckle,24655,2647,22008,2011,0.1073615899411884,0.8926384100588116
8414,Eat This New York,24640,24640,0,2004,1.0,0.0
8415,Olvidados 2015 Re-release,24638,24638,0,2015,1.0,0.0
8416,Born to Fly: Elizabeth Streb vs. Gravity,24630,24630,0,2014,1.0,0.0
8417,Bang Rajan 2004 Re-release,24629,24629,0,2004,1.0,0.0
8418,The Aspern Papers,24554,9277,15277,2019,0.3778203144090576,0.6221796855909424
8419,Immigration Tango,24554,24554,0,2011,1.0,0.0
8420,After,24544,24544,0,2011,1.0,0.0
8421,Graceland,24529,24529,0,2013,1.0,0.0
8422,Too Late to Die Young,24487,16591,7896,2018,0.6775431861804223,0.32245681381957775
8423,Sudden Fear,24476,24476,0,2016,1.0,0.0
8424,Otter 501,24449,24449,0,2012,1.0,0.0
8425,The Man Who Copied,24391,24391,0,2005,1.0,0.0
8426,Last Days in the Desert,24352,0,24352,2016,0.0,1.0
8427,Honeymoon,24343,9318,15025,2014,0.3827794437826069,0.6172205562173931
8428,Le Petit Soldat,24296,24296,0,2013,1.0,0.0
8429,Jasmine,24248,24248,0,2017,1.0,0.0
8430,Luster,24137,24137,0,2003,1.0,0.0
8431,Radio Unnameable,24090,24090,0,2012,1.0,0.0
8432,Level Up,24083,1469,22614,2016,0.06099738404683802,0.939002615953162
8433,American Storytellers,24082,24082,0,2003,1.0,0.0
8434,Chasing Einstein,24057,24057,0,2019,1.0,0.0
8435,Ranchero,24036,24036,0,2011,1.0,0.0
8436,Beneath the Darkness,23998,0,23998,2012,0.0,1.0
8437,The Fiancé,23986,23986,0,2016,1.0,0.0
8438,Harry Dean Stanton: Partly Fiction,23959,23959,0,2013,1.0,0.0
8439,Almost Holy,23957,21142,2815,2016,0.8824978085736945,0.11750219142630547
8440,Simple Creature,23918,23918,0,2017,1.0,0.0
8441,Shut Up Little Man! An Audio Misadventure,23901,23901,0,2011,1.0,0.0
8442,Dear Mr. Watterson,23899,23899,0,2013,1.0,0.0
8443,Under The Wire,23897,3429,20468,2018,0.14349081474662093,0.856509185253379
8444,Vincent N Roxxy,23896,0,23896,2017,0.0,1.0
8445,Behind the Burly Q,23889,23889,0,2010,1.0,0.0
8446,Emoticon ;),23881,23881,0,2014,1.0,0.0
8447,Happy Valley,23868,23868,0,2014,1.0,0.0
8448,Argentina,23864,14869,8995,2015,0.623072410325176,0.376927589674824
8449,Death House,23833,23833,0,2018,1.0,0.0
8450,Liars Club,23792,23792,0,2002,1.0,0.0
8451,Emmanuel's Gift,23728,23728,0,2005,1.0,0.0
8452,Greenwich Village: Music That Defined a Generation,23701,23701,0,2013,1.0,0.0
8453,Raw Faith,23667,23667,0,2011,1.0,0.0
8454,Southbound,23665,23665,0,2016,1.0,0.0
8455,Good Kids,23627,0,23627,2016,0.0,1.0
8456,Lost Bohemia,23584,23584,0,2011,1.0,0.0
8457,"A Woman, a Part",23562,23562,0,2017,1.0,0.0
8458,An Evening with Beverly Luff Linn,23515,6701,16814,2018,0.28496704231341696,0.715032957686583
8459,The Hill Chris Climbed: The Gridiron Heroes Story,23487,23487,0,2016,1.0,0.0
8460,Letter from Masanjia,23481,23481,0,2018,1.0,0.0
8461,Robert the Bruce,23425,0,23425,2019,0.0,1.0
8462,Believe Me,23419,23419,0,2014,1.0,0.0
8463,Esther Kahn,23371,23371,0,2002,1.0,0.0
8464,Can't Stand Losing You: Surviving the Police,23262,23262,0,2015,1.0,0.0
8465,For Ahkeem,23136,23136,0,2017,1.0,0.0
8466,The Judge,23127,22257,870,2018,0.9623816318588663,0.03761836814113374
8467,Finding Oscar,23116,23116,0,2017,1.0,0.0
8468,The Iran Job,23115,23115,0,2012,1.0,0.0
8469,S21: The Khmer Rouge Killing Machine,23078,22606,472,2004,0.9795476211110148,0.02045237888898518
8470,The Grace of Jake,23078,23078,0,2017,1.0,0.0
8471,Three Peaks,23069,16216,6853,2018,0.7029346742381551,0.2970653257618449
8472,History of Jazz: Oxygen for the Ears,23048,23048,0,2014,1.0,0.0
8473,Video Games: The Movie,23043,23043,0,2014,1.0,0.0
8474,Incantato 2004 Re-release,23039,23039,0,2004,1.0,0.0
8475,Goat,23020,23020,0,2016,1.0,0.0
8476,Frankie and Johnny Are Married,22900,22900,0,2004,1.0,0.0
8477,Hellbound?,22887,22887,0,2012,1.0,0.0
8478,Mirza's Lady,22886,0,22886,2016,0.0,1.0
8479,ABC Africa,22881,9075,13806,2001,0.3966172807132555,0.6033827192867445
8480,Keyhole,22826,22826,0,2012,1.0,0.0
8481,The Long Day Closes,22765,22765,0,2012,1.0,0.0
8482,Carol Channing: Larger Than Life,22740,22740,0,2012,1.0,0.0
8483,The Revisionaries,22664,22664,0,2012,1.0,0.0
8484,Ode to Joy,22594,17303,5291,2019,0.7658227848101266,0.23417721518987342
8485,Trophy,22553,21439,1114,2017,0.9506052409878952,0.04939475901210482
8486,The Other City,22539,22539,0,2010,1.0,0.0
8487,Anything,22537,19037,3500,2018,0.8446998269512358,0.15530017304876426
8488,The Black Dove,22517,22517,0,2016,1.0,0.0
8489,Casting By,22497,18164,4333,2013,0.8073965417611237,0.19260345823887629
8490,Middleground,22490,0,22490,2017,0.0,1.0
8491,Happy Tears,22464,22464,0,2010,1.0,0.0
8492,Incendiary,22457,22457,0,2011,1.0,0.0
8493,Realms,22443,147,22296,2017,0.006549926480417056,0.9934500735195829
8494,Kamikaze 89,22440,22440,0,2016,1.0,0.0
8495,Be Here Now,22424,22424,0,2016,1.0,0.0
8496,Blackmail Boy 2005 Re-release,22393,22393,0,2005,1.0,0.0
8497,Paradise Club,22381,22381,0,2017,1.0,0.0
8498,Girl Model,22369,21154,1215,2012,0.9456837587733024,0.05431624122669766
8499,Picture Me,22369,12008,10361,2010,0.5368143412758729,0.46318565872412715
8500,The Painting,22313,21008,1305,2012,0.9415139156545511,0.058486084345448844
8501,The Atomic Cafe,22293,22293,0,2018,1.0,0.0
8502,Metropolitan 2015 Re-release,22284,22284,0,2015,1.0,0.0
8503,Slow Learners,22272,22272,0,2015,1.0,0.0
8504,Generation Startup,22271,22271,0,2016,1.0,0.0
8505,Reparation,22267,22267,0,2016,1.0,0.0
8506,Winning Formula,22189,22189,0,2018,1.0,0.0
8507,All's Faire in Love,22180,22180,0,2011,1.0,0.0
8508,Princess Cut,22167,22167,0,2015,1.0,0.0
8509,Murder Eleven,22107,22107,0,2013,1.0,0.0
8510,The Garden of Eden,22083,22083,0,2010,1.0,0.0
8511,Losing Control,22081,22081,0,2012,1.0,0.0
8512,And Everything Is Going Fine,22080,22080,0,2010,1.0,0.0
8513,Cuba feliz,22071,22071,0,2002,1.0,0.0
8514,Four Adventures of Reinette and Mirabelle,22039,22039,0,2011,1.0,0.0
8515,Answers to Nothing,22029,22029,0,2011,1.0,0.0
8516,Pet,22003,8004,13999,2016,0.3637685770122256,0.6362314229877744
8517,The Sound of Silence,21994,20013,1981,2019,0.9099299809038829,0.09007001909611713
8518,Three Dancing Slaves,21888,21888,0,2005,1.0,0.0
8519,The Passion of Joan of Arc,21877,21877,0,2017,1.0,0.0
8520,Deep Gold 3D,21868,12000,9868,2011,0.5487470276202671,0.45125297237973294
8521,The ABCs of Death,21832,21832,0,2013,1.0,0.0
8522,Animals 2015 Re-release,21821,21821,0,2015,1.0,0.0
8523,Viola,21818,21818,0,2013,1.0,0.0
8524,The Female Brain,21786,21786,0,2018,1.0,0.0
8525,Master of the Flying Guillotine,21779,21779,0,2002,1.0,0.0
8526,Better Than Something: Jay Reatard,21697,21697,0,2012,1.0,0.0
8527,Crazy as Hell,21679,21679,0,2002,1.0,0.0
8528,Dead Awake,21675,11528,10147,2017,0.5318569780853518,0.46814302191464824
8529,Évocateur: The Morton Downey Jr. Movie,21652,21652,0,2013,1.0,0.0
8530,Toe to Toe,21648,21648,0,2010,1.0,0.0
8531,Sedona,21638,21638,0,2012,1.0,0.0
8532,Blue Jay,21626,21626,0,2016,1.0,0.0
8533,Wicked Witches,21600,21600,0,2019,1.0,0.0
8534,Half the Picture,21589,21589,0,2018,1.0,0.0
8535,Waiting for Lightning,21577,21577,0,2012,1.0,0.0
8536,10 timer til Paradis,21561,16000,5561,2012,0.742080608506099,0.25791939149390103
8537,Monogamy,21527,21527,0,2011,1.0,0.0
8538,Slutty Summer,21515,21515,0,2005,1.0,0.0
8539,Thank You for Your Service,21497,21497,0,2016,1.0,0.0
8540,Hagazussa,21487,13253,8234,2018,0.616791548378089,0.3832084516219109
8541,Tyrel,21456,21456,0,2018,1.0,0.0
8542,Three of Hearts 2005 Re-release,21429,21429,0,2005,1.0,0.0
8543,Almost Salinas,21419,21419,0,2003,1.0,0.0
8544,Bigger Than the Sky,21398,21398,0,2005,1.0,0.0
8545,The Guys,21366,21366,0,2003,1.0,0.0
8546,Song Of Granite,21349,16182,5167,2017,0.7579746123940231,0.24202538760597686
8547,Tio Papi,21316,21316,0,2013,1.0,0.0
8548,Memphis,21286,21286,0,2014,1.0,0.0
8549,The Burial Society,21285,21285,0,2004,1.0,0.0
8550,Resurrect Dead: The Mystery of the Toynbee Tiles,21242,21242,0,2011,1.0,0.0
8551,Already Tomorrow in Hong Kong,21206,21206,0,2016,1.0,0.0
8552,Ganja & Hess,21197,21197,0,2018,1.0,0.0
8553,NightLights,21147,21147,0,2014,1.0,0.0
8554,God Knows Where I Am,21135,21135,0,2017,1.0,0.0
8555,The Happys,21108,21108,0,2018,1.0,0.0
8556,Dallas 362,21108,21108,0,2005,1.0,0.0
8557,Massacre on Aisle 12,21106,21106,0,2017,1.0,0.0
8558,A Beginner's Guide to Snuff,21031,21031,0,2017,1.0,0.0
8559,The Sacrifice 2014 Re-release,20945,20945,0,2014,1.0,0.0
8560,Round of Your Life,20941,20941,0,2019,1.0,0.0
8561,Ava,20940,20940,0,2018,1.0,0.0
8562,Man Underground,20907,20907,0,2017,1.0,0.0
8563,Lekar Hum Deewana Dil,20874,20874,0,2014,1.0,0.0
8564,Cameraman: The Life and Work of Jack Cardiff,20840,20840,0,2011,1.0,0.0
8565,Major Dundee,20807,20807,0,2005,1.0,0.0
8566,Time Changer 2016 Re-release,20797,20797,0,2016,1.0,0.0
8567,Did You Wonder Who Fired the Gun?,20765,20765,0,2018,1.0,0.0
8568,All These Sleepless Nights,20762,20762,0,2017,1.0,0.0
8569,For Ellen,20746,12396,8350,2012,0.5975127735467078,0.4024872264532922
8570,The Ghosts in Our Machine,20709,20709,0,2013,1.0,0.0
8571,Voices in Wartime,20702,20702,0,2005,1.0,0.0
8572,The Great Flood,20694,20694,0,2014,1.0,0.0
8573,The Last Dispatch,20684,20684,0,2005,1.0,0.0
8574,Freak Show,20657,19696,961,2018,0.9534782398218522,0.046521760178147846
8575,Douchebag,20615,20615,0,2010,1.0,0.0
8576,Our Nixon,20584,20584,0,2013,1.0,0.0
8577,Fidelio: Alice's Odyssey,20571,3580,16991,2015,0.17403140343201595,0.825968596567984
8578,Coming Up Roses 2014 Re-release,20567,20567,0,2014,1.0,0.0
8579,Band of Robbers,20555,20555,0,2016,1.0,0.0
8580,The Work,20554,5853,14701,2017,0.28476209010411596,0.715237909895884
8581,Ice Dragon: Legend of the Blue Daisies,20549,20549,0,2018,1.0,0.0
8582,This Last Lonely Place,20507,20507,0,2016,1.0,0.0
8583,Consumed,20476,20476,0,2015,1.0,0.0
8584,The Devil and Father Amorth,20449,20449,0,2018,1.0,0.0
8585,Boy Meets Girl,20441,20441,0,2015,1.0,0.0
8586,Burden,20437,18440,1997,2017,0.9022850711944023,0.09771492880559769
8587,Never,20431,20431,0,2016,1.0,0.0
8588,Orwell Rolls in His Grave,20389,20389,0,2004,1.0,0.0
8589,The Highest Pass,20386,20386,0,2012,1.0,0.0
8590,Koroshiya 1 2017 Re-release,20285,20285,0,2017,1.0,0.0
8591,The Korean,20279,20279,0,2010,1.0,0.0
8592,Double Take,20218,20218,0,2010,1.0,0.0
8593,Izzy Gets the F*ck Across Town,20208,20208,0,2018,1.0,0.0
8594,New World Order,20205,20205,0,2016,1.0,0.0
8595,Jesus Henry Christ,20183,20183,0,2012,1.0,0.0
8596,Shoah,20175,20175,0,2010,1.0,0.0
8597,Chaos,20166,10289,9877,2005,0.5102152137260736,0.4897847862739264
8598,Friends and Romans,20136,20136,0,2015,1.0,0.0
8599,How to Grow a Band,20135,20135,0,2012,1.0,0.0
8600,The Man from Outer Space,20102,20102,0,2017,1.0,0.0
8601,Love Me True,20100,20100,0,2016,1.0,0.0
8602,"Float Like a Butterfly, Sting Like a Bee",20073,20073,0,2003,1.0,0.0
8603,The Past is a Grotesque Animal,20056,20056,0,2014,1.0,0.0
8604,Apocalypsis,20052,20052,0,2018,1.0,0.0
8605,General Magic,20046,20046,0,2019,1.0,0.0
8606,The Gospel of Eureka,20039,20039,0,2019,1.0,0.0
8607,The Deal,20035,0,20035,2005,0.0,1.0
8608,"No Pay, Nudity",20017,20017,0,2016,1.0,0.0
8609,Eight Hours Don't Make a Day,19987,19987,0,2018,1.0,0.0
8610,"One Sings, the Other Doesn't",19919,19919,0,2018,1.0,0.0
8611,Wedding Palace,19908,19908,0,2013,1.0,0.0
8612,Forbidden Games,19889,19889,0,2015,1.0,0.0
8613,Merci Dr Rey!,19867,19867,0,2004,1.0,0.0
8614,Active Measures,19862,19862,0,2018,1.0,0.0
8615,Heat and Dust 2017 Re-release,19856,19856,0,2017,1.0,0.0
8616,"Sia, the Dream of the Python",19830,4662,15168,2002,0.2350983358547655,0.7649016641452345
8617,The Simian Line,19823,19823,0,2001,1.0,0.0
8618,The Journey,19800,19800,0,2003,1.0,0.0
8619,Wild Canaries,19777,19777,0,2015,1.0,0.0
8620,The Trial,19753,19753,0,2010,1.0,0.0
8621,The Romans,19705,19705,0,2016,1.0,0.0
8622,Trafficked,19698,19698,0,2017,1.0,0.0
8623,Kills On Wheels 2016 Re-release,19680,15898,3782,2016,0.8078252032520326,0.19217479674796747
8624,Misery Loves Comedy,19634,19634,0,2015,1.0,0.0
8625,Bad Milo,19613,19613,0,2013,1.0,0.0
8626,Art Bastard,19600,19600,0,2016,1.0,0.0
8627,Uzumasa Limelight,19597,19597,0,2014,1.0,0.0
8628,Zoology,19572,0,19572,2016,0.0,1.0
8629,Damascus Cover,19532,0,19532,2018,0.0,1.0
8630,Comet,19530,8623,10907,2014,0.4415258576548899,0.5584741423451101
8631,Hannah: Buddhism's Untold Journey,19526,396,19130,2016,0.02028065143910683,0.9797193485608932
8632,BOSTON: An American Running Story 2017 Re-release,19499,19499,0,2017,1.0,0.0
8633,Grassroots,19492,12356,7136,2012,0.6339010876256926,0.3660989123743074
8634,In Over My Head,19482,19482,0,2012,1.0,0.0
8635,Guardian Angel,19480,19480,0,2014,1.0,0.0
8636,A Picture of You,19480,19480,0,2014,1.0,0.0
8637,A Room for Romeo Brass,19478,19478,0,2000,1.0,0.0
8638,Whensday,19463,19463,0,2013,1.0,0.0
8639,Hunter Gatherer,19462,19462,0,2016,1.0,0.0
8640,Skateland,19411,19411,0,2011,1.0,0.0
8641,Garmento,19402,19402,0,2003,1.0,0.0
8642,Mansfield 66/67,19390,17930,1460,2017,0.9247034553893759,0.07529654461062403
8643,Tchoupitoulas,19375,19375,0,2012,1.0,0.0
8644,Actress,19365,19365,0,2014,1.0,0.0
8645,Peter Brook: The Tightrope,19365,19365,0,2014,1.0,0.0
8646,Watchers of the Sky,19339,19339,0,2014,1.0,0.0
8647,Gabo: The Creation of Gabriel Garcia Marquez,19337,19337,0,2015,1.0,0.0
8648,Melancholian 3 huonetta,19317,19317,0,2005,1.0,0.0
8649,Jackie & Ryan,19305,0,19305,2015,0.0,1.0
8650,Reuniting the Rubins,19288,13569,5719,2011,0.703494400663625,0.29650559933637494
8651,Romeos,19248,1081,18167,2011,0.056161679135494594,0.9438383208645054
8652,Neshoba,19245,19245,0,2010,1.0,0.0
8653,The Manson Family,19140,19140,0,2004,1.0,0.0
8654,The People I've Slept With,19137,19137,0,2010,1.0,0.0
8655,Who We Are Now,19128,19128,0,2018,1.0,0.0
8656,L'important c'est d'aimer,19120,19120,0,2017,1.0,0.0
8657,Revelation: Dawn of Global Government,19107,19107,0,2016,1.0,0.0
8658,Make Believe,19085,19085,0,2011,1.0,0.0
8659,November,19084,19084,0,2018,1.0,0.0
8660,Search Engines,19033,19033,0,2016,1.0,0.0
8661,The Challenger,19003,19003,0,2015,1.0,0.0
8662,The Color Wheel,19001,19001,0,2012,1.0,0.0
8663,The Kill Team,18983,18983,0,2014,1.0,0.0
8664,Sophomore,18945,18945,0,2012,1.0,0.0
8665,Devils on the Doorstep,18944,18944,0,2002,1.0,0.0
8666,Smash & Grab: The Story of the Pink Panthers,18938,18938,0,2013,1.0,0.0
8667,Love and a Bullet,18926,18926,0,2002,1.0,0.0
8668,The Deserted Station,18867,18867,0,2004,1.0,0.0
8669,Ktown Cowboys,18863,18863,0,2016,1.0,0.0
8670,Nostalgia,18846,18846,0,2013,1.0,0.0
8671,Frank and Ava,18829,18829,0,2018,1.0,0.0
8672,Test,18823,18823,0,2014,1.0,0.0
8673,A League of Ordinary Gentlemen 2005 Re-release,18807,18807,0,2005,1.0,0.0
8674,Scandalous: The True Story of the National Enquirer,18759,18759,0,2019,1.0,0.0
8675,The Sorcerer and the White Snake 2013 Re-release,18759,18759,0,2013,1.0,0.0
8676,Before Stonewall,18724,18724,0,2019,1.0,0.0
8677,Seoul Searching,18654,18654,0,2016,1.0,0.0
8678,Crime + Punishment,18644,18644,0,2018,1.0,0.0
8679,A Single Shot,18642,18642,0,2013,1.0,0.0
8680,Wish Me Away,18618,18618,0,2012,1.0,0.0
8681,The Return of Martin Guerre 2019 Re-release,18603,18603,0,2019,1.0,0.0
8682,The Pagan King: The Battle of Death,18598,0,18598,2018,0.0,1.0
8683,Bobbi Jene,18579,18579,0,2017,1.0,0.0
8684,La Camioneta: The Journey of One American School Bus,18558,18558,0,2013,1.0,0.0
8685,Let My People Go!,18529,18529,0,2013,1.0,0.0
8686,Allegiance to Broadway,18527,18527,0,2018,1.0,0.0
8687,Mr Ya Miss,18516,18516,0,2005,1.0,0.0
8688,Venus Boyz 2003 Re-release,18515,18515,0,2003,1.0,0.0
8689,Desolation,18490,18490,0,2018,1.0,0.0
8690,All the Rage,18489,18489,0,2017,1.0,0.0
8691,The Ghoul,18459,2032,16427,2017,0.11008180291456741,0.8899181970854326
8692,306 Hollywood,18399,18399,0,2018,1.0,0.0
8693,The Reception,18389,18389,0,2005,1.0,0.0
8694,Oka!,18364,18364,0,2011,1.0,0.0
8695,"Phoenix, Oregon",18356,18356,0,2019,1.0,0.0
8696,"Intent to Destroy: Death, Denial & Depiction 2017 Re-release",18340,18340,0,2017,1.0,0.0
8697,The Channel,18319,18319,0,2016,1.0,0.0
8698,Four Bags Full,18297,18297,0,2013,1.0,0.0
8699,The Life: What's Your Pleasure?,18297,5130,13167,2004,0.2803738317757009,0.719626168224299
8700,SHOT! The Psycho-Spiritual Mantra of Rock,18295,15157,3138,2017,0.8284777261546871,0.17152227384531293
8701,Hell House,18279,18279,0,2002,1.0,0.0
8702,Off and Running,18262,18262,0,2010,1.0,0.0
8703,Tosca's Kiss,18236,18236,0,2014,1.0,0.0
8704,Torn,18202,18202,0,2013,1.0,0.0
8705,Marcelino Pan y Vino 2012 Re-release,18193,18193,0,2012,1.0,0.0
8706,Who is Dayani Cristal?,18190,18190,0,2014,1.0,0.0
8707,The Lion in Winter 2016 Re-release,18177,18177,0,2016,1.0,0.0
8708,Restless,18154,18154,0,2000,1.0,0.0
8709,Coming Through the Rye,18137,18137,0,2016,1.0,0.0
8710,King of Hearts,18130,17646,484,2018,0.973303916161059,0.02669608383894098
8711,Peter and the Farm,18123,18123,0,2016,1.0,0.0
8712,Harry Benson: Shoot First,18092,18092,0,2016,1.0,0.0
8713,A Bit of Bad Luck,18089,18089,0,2016,1.0,0.0
8714,Total Recall 2012 Re-release,18081,18081,0,2012,1.0,0.0
8715,Scarlet Diva,18062,18062,0,2002,1.0,0.0
8716,Holy Hell,18051,18051,0,2016,1.0,0.0
8717,On Tour with Pina Bausch,18016,18016,0,2014,1.0,0.0
8718,I Knew Her Well,18010,18010,0,2016,1.0,0.0
8719,Men Go to Battle,18006,18006,0,2016,1.0,0.0
8720,Battle for Brooklyn,18000,18000,0,2011,1.0,0.0
8721,Jamel Shabazz Street Photographer,17992,17992,0,2013,1.0,0.0
8722,Payback,17979,17979,0,2012,1.0,0.0
8723,Cook County,17977,17977,0,2011,1.0,0.0
8724,The King Is Alive,17929,17929,0,2001,1.0,0.0
8725,The Cranes Are Flying,17923,17923,0,2019,1.0,0.0
8726,Great Directors,17921,17921,0,2010,1.0,0.0
8727,Dealin' with Idiots,17909,17909,0,2013,1.0,0.0
8728,Li'l Quinquin,17868,7192,10676,2015,0.4025072755764495,0.5974927244235505
8729,The Thorn in the Heart,17849,7376,10473,2010,0.41324443946439576,0.5867555605356042
8730,The Last Shaman,17844,17844,0,2017,1.0,0.0
8731,David,17828,0,17828,2013,0.0,1.0
8732,Batman: Mask of the Phantasm 2018 Re-release,17813,17813,0,2018,1.0,0.0
8733,Purple Butterfly,17790,17790,0,2004,1.0,0.0
8734,Escapes,17778,17778,0,2017,1.0,0.0
8735,Sacred,17740,17740,0,2017,1.0,0.0
8736,Little Birds,17739,17739,0,2012,1.0,0.0
8737,The Other One,17727,17727,0,2015,1.0,0.0
8738,Kelly & Cal,17702,17702,0,2014,1.0,0.0
8739,Bad Grandmas,17688,17688,0,2017,1.0,0.0
8740,The History of Future Folk,17646,17646,0,2013,1.0,0.0
8741,Night at the Golden Eagle,17643,17643,0,2002,1.0,0.0
8742,How He Fell in Love,17575,17575,0,2016,1.0,0.0
8743,"Milwaukee, Minnesota",17528,17528,0,2005,1.0,0.0
8744,The Chronicle of Anna Magdalena Bach,17527,17527,0,2018,1.0,0.0
8745,Sunset Story,17508,17508,0,2005,1.0,0.0
8746,Streit's: Matzo and the American Dream,17506,17506,0,2016,1.0,0.0
8747,Butterfly Girl,17503,17503,0,2015,1.0,0.0
8748,Chained for Life,17431,17431,0,2019,1.0,0.0
8749,A Skin Too Few: The Days of Nick Drake,17384,17384,0,2002,1.0,0.0
8750,Transfixed,17361,17361,0,2004,1.0,0.0
8751,The Law,17351,17351,0,2010,1.0,0.0
8752,"A Bread Factory, Part One/A Bread Factory, Part Two",17325,17325,0,2018,1.0,0.0
8753,Littlerock,17309,17309,0,2011,1.0,0.0
8754,The Homestretch,17306,17306,0,2014,1.0,0.0
8755,Stand Clear of the Closing Doors,17282,17282,0,2014,1.0,0.0
8756,Archie's Final Project,17282,17282,0,2011,1.0,0.0
8757,The Great Water,17257,17257,0,2005,1.0,0.0
8758,Revival,17252,17252,0,2018,1.0,0.0
8759,Speedway Junky,17246,17246,0,2001,1.0,0.0
8760,A Real Young Girl,17245,17245,0,2001,1.0,0.0
8761,Landfill Harmonic,17205,17205,0,2016,1.0,0.0
8762,Food Evolution,17181,17181,0,2017,1.0,0.0
8763,Accident 2014 Re-release,17161,17161,0,2014,1.0,0.0
8764,Pandaemonium,17113,5151,11962,2001,0.30099924034359843,0.6990007596564015
8765,Le Pont du Nord,17110,17110,0,2013,1.0,0.0
8766,Always Shine,17102,17102,0,2016,1.0,0.0
8767,On the Map,17099,17099,0,2016,1.0,0.0
8768,Grandmaster,17077,17077,0,2012,1.0,0.0
8769,The Understudy,17036,17036,0,2012,1.0,0.0
8770,Goodbye to All That,16986,16986,0,2014,1.0,0.0
8771,The Prophet's Son,16983,16983,0,2012,1.0,0.0
8772,Joseph Pulitzer: Voice of the People,16970,16970,0,2019,1.0,0.0
8773,Eban and Charley,16918,16918,0,2001,1.0,0.0
8774,Carbon Nation,16901,16901,0,2010,1.0,0.0
8775,Return,16886,16124,762,2012,0.9548738600023688,0.045126139997631175
8776,Hank and Asha,16878,16878,0,2014,1.0,0.0
8777,Hidden in Plain Sight,16803,16803,0,2003,1.0,0.0
8778,Swim Team,16783,16783,0,2017,1.0,0.0
8779,Cuban Rafters 2003 Re-release,16783,16783,0,2003,1.0,0.0
8780,Night Across the Street,16778,16778,0,2013,1.0,0.0
8781,Eva 2015 Re-release,16738,16738,0,2015,1.0,0.0
8782,Inventing Our Life: The Kibbutz Experiment,16734,16734,0,2012,1.0,0.0
8783,Medea,16714,16714,0,2003,1.0,0.0
8784,This Changes Everything,16692,16692,0,2015,1.0,0.0
8785,Fascination,16670,16670,0,2005,1.0,0.0
8786,The World of Kanako 2015 Re-release,16627,16627,0,2015,1.0,0.0
8787,The Freebie,16613,16613,0,2010,1.0,0.0
8788,The Freedom to Marry,16611,16611,0,2017,1.0,0.0
8789,Who Took Johnny,16595,16595,0,2015,1.0,0.0
8790,Haikara-San: Here Comes Miss Modern,16572,16572,0,2018,1.0,0.0
8791,Life in a Walk,16557,16557,0,2015,1.0,0.0
8792,Brave New Jersey,16544,16544,0,2017,1.0,0.0
8793,33 & Beyond: The Royal Art of Freemasonry,16533,16533,0,2017,1.0,0.0
8794,Bright Future,16483,5166,11317,2004,0.3134138202997027,0.6865861797002972
8795,The Last Mogul,16469,16469,0,2005,1.0,0.0
8796,Ethan Mao,16444,10178,6266,2005,0.6189491607881294,0.3810508392118706
8797,Mission Control: The Unsung Heroes of Apollo,16405,16405,0,2017,1.0,0.0
8798,Magician: The Astonishing Life and Work of Orson Welles,16400,16400,0,2014,1.0,0.0
8799,Dying to Know: Ram Dass & Timothy Leary,16397,16397,0,2017,1.0,0.0
8800,Design Is One: The Vignellis,16386,16386,0,2013,1.0,0.0
8801,The Intended,16290,8106,8184,2003,0.4976058931860037,0.5023941068139963
8802,Faster,16265,16265,0,2004,1.0,0.0
8803,Onmyoji: The Yin Yang Master,16234,16234,0,2003,1.0,0.0
8804,I Melt with You,16232,6361,9871,2011,0.3918802365697388,0.6081197634302612
8805,Perfect Opposites,16201,16201,0,2004,1.0,0.0
8806,The Human Centipede III (Final Sequence),16184,16184,0,2015,1.0,0.0
8807,This is Our Land,16182,11567,4615,2017,0.7148065752070202,0.2851934247929799
8808,Detour,16172,16172,0,2018,1.0,0.0
8809,All the Queen's Horses,16172,16172,0,2017,1.0,0.0
8810,Virginia Minnesota,16118,16118,0,2019,1.0,0.0
8811,Levitated Mass,16086,16086,0,2014,1.0,0.0
8812,1920 London,16077,0,16077,2016,0.0,1.0
8813,Out of the Clear Blue Sky,16050,16050,0,2013,1.0,0.0
8814,Night of Henna,16027,16027,0,2005,1.0,0.0
8815,Long Shot: The Kevin Laue Story,16011,16011,0,2012,1.0,0.0
8816,Planet of Snail,16002,13957,2045,2012,0.8722034745656793,0.1277965254343207
8817,Wattstax,16000,16000,0,2003,1.0,0.0
8818,Supercapitalist,16000,16000,0,2012,1.0,0.0
8819,Vulgar,15927,15927,0,2002,1.0,0.0
8820,Charged: The Eduardo Garcia Story,15920,15920,0,2017,1.0,0.0
8821,Can You Dig This,15909,15909,0,2015,1.0,0.0
8822,Bobby G. Can't Swim,15900,15900,0,2002,1.0,0.0
8823,This Binary Universe,15875,15875,0,2012,1.0,0.0
8824,Starfish,15849,15849,0,2019,1.0,0.0
8825,A Reason,15792,15792,0,2015,1.0,0.0
8826,Defining Hope,15788,15788,0,2017,1.0,0.0
8827,Take Me Home,15760,15760,0,2012,1.0,0.0
8828,Full Moon in Paris,15726,15726,0,2015,1.0,0.0
8829,Trinity Seven The Movie 2: Heavens Library & Crimson Lord,15712,15712,0,2019,1.0,0.0
8830,People Say I'm Crazy,15679,15679,0,2004,1.0,0.0
8831,A Letter to True,15635,15635,0,2004,1.0,0.0
8832,7th Street,15629,15629,0,2003,1.0,0.0
8833,Breakdance Academy,15628,15628,0,2010,1.0,0.0
8834,Dreams Rewired,15626,11843,3783,2015,0.7579034941763727,0.2420965058236273
8835,Out on Stage,15623,15623,0,2018,1.0,0.0
8836,The Competition 2019 Re-release,15622,15622,0,2019,1.0,0.0
8837,Basmati Blues,15605,0,15605,2017,0.0,1.0
8838,Five Nights in Maine,15587,15587,0,2016,1.0,0.0
8839,Bob le Flambeur,15586,15586,0,2018,1.0,0.0
8840,When You Read This Letter,15552,15552,0,2018,1.0,0.0
8841,Postcards from London,15548,5312,10236,2018,0.3416516593774119,0.6583483406225881
8842,Stuffed,15532,15532,0,2019,1.0,0.0
8843,Bomb the System,15520,15520,0,2005,1.0,0.0
8844,Save the Green Planet!,15516,15516,0,2005,1.0,0.0
8845,Last Dance,15515,15515,0,2002,1.0,0.0
8846,Dreamkiller,15514,15514,0,2010,1.0,0.0
8847,One Bright Shining Moment,15504,15504,0,2005,1.0,0.0
8848,Tom of Finland 2018 Re-release,15483,3314,12169,2018,0.21404120648453143,0.7859587935154686
8849,Abouna,15476,3290,12186,2003,0.21258723184285344,0.7874127681571466
8850,They Will Have to Kill Us First: Malian Music In Exile,15453,7516,7937,2015,0.48637804956966285,0.5136219504303372
8851,California Solo,15433,15433,0,2012,1.0,0.0
8852,Pipe Dream,15430,15430,0,2002,1.0,0.0
8853,Formula 17 2005 Re-release,15427,15427,0,2005,1.0,0.0
8854,Be Somebody,15395,15395,0,2016,1.0,0.0
8855,Keeper of the Flame,15392,0,15392,2002,0.0,1.0
8856,Between the Lines,15383,15383,0,2019,1.0,0.0
8857,Dumbstruck,15379,15379,0,2011,1.0,0.0
8858,The Adderall Diaries,15364,13191,2173,2016,0.8585654777401718,0.14143452225982817
8859,Wild Side,15355,15355,0,2005,1.0,0.0
8860,The President,15338,7578,7760,2016,0.4940670230799322,0.5059329769200678
8861,Narcissister Organ Player,15334,15334,0,2018,1.0,0.0
8862,Only the Young,15312,15312,0,2012,1.0,0.0
8863,Contemporary Color,15305,15305,0,2017,1.0,0.0
8864,Starcrossed,15263,15263,0,2016,1.0,0.0
8865,Harry + Max,15247,15247,0,2005,1.0,0.0
8866,"Arabian Nights - Volume 2, The Desolate One",15245,6398,8847,2015,0.4196785831420138,0.5803214168579862
8867,People's Republic of Desire,15241,15241,0,2018,1.0,0.0
8868,The Samaritan,15220,2521,12699,2012,0.16563731931668857,0.8343626806833114
8869,Off the Lip,15217,15217,0,2004,1.0,0.0
8870,Funan,15152,15152,0,2019,1.0,0.0
8871,The Olivia Experiment,15122,15122,0,2014,1.0,0.0
8872,Kung Fu Joe,15120,15120,0,2012,1.0,0.0
8873,Nora,15120,15120,0,2001,1.0,0.0
8874,Trade of Innocents,15091,15091,0,2012,1.0,0.0
8875,Rebels on Pointe,15088,15088,0,2017,1.0,0.0
8876,Khachaturian,15084,15084,0,2003,1.0,0.0
8877,Cheatin',15077,15077,0,2015,1.0,0.0
8878,Barefoot,15071,15071,0,2014,1.0,0.0
8879,Caught in the Web,15033,1067,13966,2012,0.07097718352956828,0.9290228164704317
8880,I'm Not Jesus Mommy,15005,15005,0,2011,1.0,0.0
8881,The Tenant,15003,15003,0,2011,1.0,0.0
8882,Wrinkles the Clown,14938,14938,0,2019,1.0,0.0
8883,I Declare War,14928,14928,0,2013,1.0,0.0
8884,La Maison de la radio,14905,8095,6810,2013,0.5431063401543106,0.45689365984568936
8885,Trust Machine: The Story of Blockchain,14905,14905,0,2018,1.0,0.0
8886,ZZ Top: That Little Ol' Band from Texas,14879,14879,0,2019,1.0,0.0
8887,A Tale of Two Pizzas,14831,14831,0,2005,1.0,0.0
8888,Reeseville,14824,14824,0,2004,1.0,0.0
8889,Horses of God 2014 Re-release,14817,14817,0,2014,1.0,0.0
8890,Vince Giordano: There's a Future in the Past,14807,14807,0,2017,1.0,0.0
8891,Kiss of the Damned,14752,14752,0,2013,1.0,0.0
8892,The Prey 2012 Re-release,14738,13959,779,2012,0.9471434387298141,0.05285656127018591
8893,Two Ninas,14725,14725,0,2001,1.0,0.0
8894,Sweet Virginia,14725,11753,2972,2017,0.7981663837011884,0.20183361629881155
8895,Gloria,14701,14701,0,2015,1.0,0.0
8896,30 Beats,14693,14693,0,2012,1.0,0.0
8897,Circus,14693,14693,0,2000,1.0,0.0
8898,Last Men in Aleppo,14637,14637,0,2017,1.0,0.0
8899,10 Days in a Madhouse,14616,14616,0,2015,1.0,0.0
8900,Unraveled,14615,14615,0,2012,1.0,0.0
8901,The Next Big Thing,14600,14600,0,2002,1.0,0.0
8902,Buzzard,14591,14591,0,2015,1.0,0.0
8903,Tristana,14586,14586,0,2012,1.0,0.0
8904,The Settlers,14556,14556,0,2002,1.0,0.0
8905,Ferrante Fever,14518,11137,3381,2018,0.7671166827386693,0.23288331726133077
8906,The Wanderers 2016 Re-release,14492,14492,0,2016,1.0,0.0
8907,Antarctica: Ice and Sky 2017 Re-release,14475,14475,0,2017,1.0,0.0
8908,The Public Image is Rotten,14464,11293,3171,2018,0.7807660398230089,0.21923396017699115
8909,The 24th Day,14460,14460,0,2004,1.0,0.0
8910,The Two Escobars,14457,14457,0,2010,1.0,0.0
8911,My Son 2019 Re-release,14450,14450,0,2019,1.0,0.0
8912,The Last Movie Star,14410,14410,0,2018,1.0,0.0
8913,The Unbelievers,14400,14400,0,2013,1.0,0.0
8914,The Uncondemned,14393,14393,0,2016,1.0,0.0
8915,A Silent Love,14389,14389,0,2004,1.0,0.0
8916,Exhibition,14378,14344,34,2014,0.9976352761162888,0.0023647238837112253
8917,The Anarchist Cookbook,14369,14369,0,2003,1.0,0.0
8918,Justice Is Mind,14360,14360,0,2013,1.0,0.0
8919,Gone Doggy Gone,14354,14354,0,2015,1.0,0.0
8920,Peep World,14351,14351,0,2011,1.0,0.0
8921,Machines,14331,9710,4621,2017,0.6775521596538971,0.32244784034610285
8922,Never Stand Still,14272,14272,0,2012,1.0,0.0
8923,Combat Obscura,14242,14242,0,2019,1.0,0.0
8924,Saheb Biwi Aur Gangster,14231,14231,0,2011,1.0,0.0
8925,Brother Nature,14218,14218,0,2016,1.0,0.0
8926,Crutch,14189,14189,0,2004,1.0,0.0
8927,A Perfect Man,14147,7117,7030,2013,0.5030748568601117,0.49692514313988834
8928,Newtown,14109,14109,0,2016,1.0,0.0
8929,We Won't Grow Old Together,14104,14104,0,2012,1.0,0.0
8930,Shangri-La Suite,14073,14073,0,2016,1.0,0.0
8931,Gayby,14062,14062,0,2012,1.0,0.0
8932,6 Month Rule,14057,14057,0,2012,1.0,0.0
8933,Head Games,14056,14056,0,2012,1.0,0.0
8934,Ghetto Physics,14034,14034,0,2010,1.0,0.0
8935,Chasing the Blues,14030,14030,0,2018,1.0,0.0
8936,Il Futuro,14001,14001,0,2013,1.0,0.0
8937,Screwball,13967,13967,0,2019,1.0,0.0
8938,Yosemite,13931,13931,0,2016,1.0,0.0
8939,Up for Grabs,13931,13931,0,2005,1.0,0.0
8940,Weed the People,13926,13926,0,2018,1.0,0.0
8941,This Is Martin Bonner,13888,13888,0,2013,1.0,0.0
8942,Falling Away,13869,13869,0,2012,1.0,0.0
8943,Genesis,13856,6784,7072,2019,0.4896073903002309,0.5103926096997691
8944,Blackfoot Trail,13848,13848,0,2015,1.0,0.0
8945,Sympathy for Delicious,13826,13826,0,2011,1.0,0.0
8946,Stavisky...,13793,13793,0,2018,1.0,0.0
8947,The Pretty One,13769,13769,0,2014,1.0,0.0
8948,A Space Program,13739,13739,0,2016,1.0,0.0
8949,Dorfman in Love,13737,13737,0,2013,1.0,0.0
8950,Don McKay,13722,13722,0,2010,1.0,0.0
8951,Time to Die,13707,13707,0,2017,1.0,0.0
8952,Daisies,13692,13692,0,2012,1.0,0.0
8953,This One's for the Ladies,13688,13688,0,2019,1.0,0.0
8954,The Law in These Parts,13683,13683,0,2012,1.0,0.0
8955,Tikkun,13671,13671,0,2016,1.0,0.0
8956,Red Trees,13666,13666,0,2017,1.0,0.0
8957,Soft Fruit,13654,13654,0,2000,1.0,0.0
8958,Fifi Howls from Happiness,13614,13614,0,2014,1.0,0.0
8959,When the Iron Bird Flies: Tibetan Buddhism Arrives in the West,13598,13598,0,2012,1.0,0.0
8960,Stray Dogs,13573,10433,3140,2014,0.7686583658734252,0.23134163412657482
8961,Eli,13547,13547,0,2015,1.0,0.0
8962,Dysfunctional Friends,13546,13546,0,2012,1.0,0.0
8963,Paper Man,13514,13514,0,2010,1.0,0.0
8964,Duane Hopwood,13510,13510,0,2005,1.0,0.0
8965,Handsome Harry,13500,13500,0,2010,1.0,0.0
8966,Shadowman,13498,13498,0,2017,1.0,0.0
8967,Looking for an Echo,13465,13465,0,2000,1.0,0.0
8968,Spices of Liberty,13463,13463,0,2016,1.0,0.0
8969,The Slaughter Rule,13411,13411,0,2003,1.0,0.0
8970,War of the Worlds: Goliath,13385,13385,0,2014,1.0,0.0
8971,Solaris 2017 Re-release,13352,0,13352,2017,0.0,1.0
8972,Yes Nurse! No Nurse! 2004 Re-release,13325,13325,0,2004,1.0,0.0
8973,Violet Tendencies,13304,13304,0,2010,1.0,0.0
8974,Rapid Response,13294,13294,0,2019,1.0,0.0
8975,The Specials,13276,13276,0,2000,1.0,0.0
8976,Late Spring,13254,13254,0,2016,1.0,0.0
8977,Days and Nights,13243,13243,0,2014,1.0,0.0
8978,Our Blood is Wine,13210,13210,0,2018,1.0,0.0
8979,"Intent to Destroy: Death, Denial & Depiction",13194,13194,0,2017,1.0,0.0
8980,Sol LeWitt,13146,13146,0,2014,1.0,0.0
8981,The Pleasures of Being Out of Step,13137,13137,0,2014,1.0,0.0
8982,The Trouble with Bliss,13093,13093,0,2012,1.0,0.0
8983,Under the Boardwalk: The Monopoly Story,13080,13080,0,2011,1.0,0.0
8984,Nothing But a Man,13063,13063,0,2012,1.0,0.0
8985,"How Much Does Your Building Weigh, Mr Foster? 2012 Re-release",13013,13013,0,2012,1.0,0.0
8986,Jim,13000,13000,0,2010,1.0,0.0
8987,Bloodworth,12971,12971,0,2011,1.0,0.0
8988,Like Me,12965,12965,0,2018,1.0,0.0
8989,K2: Siren of the Himalayas,12959,12959,0,2014,1.0,0.0
8990,The Last Rampage,12944,6294,6650,2017,0.48624845488257107,0.5137515451174289
8991,A Green Story,12901,12901,0,2013,1.0,0.0
8992,Taipei Story,12897,12897,0,2017,1.0,0.0
8993,Permanent,12847,12847,0,2017,1.0,0.0
8994,The Taqwacores,12839,11445,1394,2010,0.8914245657761508,0.10857543422384922
8995,Children Underground,12798,12798,0,2001,1.0,0.0
8996,Junction 48,12795,12795,0,2017,1.0,0.0
8997,Yakuza Apocalypse,12756,12756,0,2015,1.0,0.0
8998,Virginia,12728,12728,0,2012,1.0,0.0
8999,Breakdance Academy 2013 Re-release,12708,12708,0,2013,1.0,0.0
9000,Concerning Violence,12680,12680,0,2014,1.0,0.0
9001,Heal,12668,12668,0,2017,1.0,0.0
9002,Bhopal: A Prayer for Rain,12628,12628,0,2014,1.0,0.0
9003,Kangaroo,12626,4547,8079,2018,0.3601298907017266,0.6398701092982734
9004,Lansdown,12614,12614,0,2002,1.0,0.0
9005,American Socialist: The Life and Times of Eugene Victor Debs,12609,12609,0,2018,1.0,0.0
9006,Gory Gory Hallelujah,12604,12604,0,2005,1.0,0.0
9007,Freestyle: The Art of Rhyme,12600,12600,0,2004,1.0,0.0
9008,Buddy Boy,12597,12597,0,2000,1.0,0.0
9009,Boy Meets Girl,12589,12589,0,2014,1.0,0.0
9010,Husbands in Goa,12588,10135,2453,2012,0.8051318716237686,0.19486812837623133
9011,Of Fathers and Sons,12579,12579,0,2018,1.0,0.0
9012,Around June,12578,12578,0,2012,1.0,0.0
9013,My Art,12554,12554,0,2018,1.0,0.0
9014,Daltry Calhoun,12551,12551,0,2005,1.0,0.0
9015,Off Season,12544,12544,0,2019,1.0,0.0
9016,The Far Side of the Moon 2005 Re-release,12534,12534,0,2005,1.0,0.0
9017,City of Women,12516,12516,0,2016,1.0,0.0
9018,Seven Beauties,12408,12408,0,2017,1.0,0.0
9019,American Chaos,12368,12368,0,2018,1.0,0.0
9020,America the Beautiful 2: The Thin Commandments,12366,12366,0,2011,1.0,0.0
9021,Rebirth,12358,12358,0,2011,1.0,0.0
9022,Spin,12355,12355,0,2004,1.0,0.0
9023,L'héritage de la chouette,12316,12316,0,2018,1.0,0.0
9024,The Dust Factory,12311,12311,0,2004,1.0,0.0
9025,Big Ain't Bad,12288,12288,0,2004,1.0,0.0
9026,4 Days in France,12273,12273,0,2017,1.0,0.0
9027,The Armor of Light,12267,12267,0,2015,1.0,0.0
9028,Wa-shoku Dream: Beyond Sushi,12240,12240,0,2015,1.0,0.0
9029,The Living Wake,12232,12232,0,2010,1.0,0.0
9030,Bricked,12201,12201,0,2019,1.0,0.0
9031,Elstree 1976,12173,12173,0,2016,1.0,0.0
9032,Destiny,12156,12156,0,2016,1.0,0.0
9033,Touch the Wall,12156,12156,0,2014,1.0,0.0
9034,Greetings from Tim Buckley,12155,11157,998,2013,0.9178938708350473,0.08210612916495269
9035,Shahid,12153,12153,0,2013,1.0,0.0
9036,Back Door Channels: The Price of Peace,12139,12139,0,2011,1.0,0.0
9037,In No Great Hurry: 13 Lessons in Life with Saul Leiter,12133,12133,0,2014,1.0,0.0
9038,The Most Unknown,12119,12119,0,2018,1.0,0.0
9039,Call Me Kuchu,12110,9124,2986,2012,0.7534269199009084,0.24657308009909165
9040,Zen for Nothing,12107,12107,0,2019,1.0,0.0
9041,Hot Water,12101,12101,0,2016,1.0,0.0
9042,The Kids Grow Up,12095,12095,0,2010,1.0,0.0
9043,A Murder in the Park,12088,12088,0,2015,1.0,0.0
9044,When Two Worlds Collide,12080,12080,0,2016,1.0,0.0
9045,Little England 2015 Re-release,12077,12077,0,2015,1.0,0.0
9046,Close Call,12077,12077,0,2004,1.0,0.0
9047,Imprisoned,12050,12050,0,2019,1.0,0.0
9048,Quartet,12042,12042,0,2019,1.0,0.0
9049,Lost Angels: Skid Row Is My Home,12025,12025,0,2012,1.0,0.0
9050,Queen Margot 2014 Re-release,12005,12005,0,2014,1.0,0.0
9051,Shaye & Kiki,12000,12000,0,2002,1.0,0.0
9052,Rick,11991,11991,0,2004,1.0,0.0
9053,The Legend of Leigh Bowery,11989,11989,0,2003,1.0,0.0
9054,All Babes Want to Kill Me,11975,11975,0,2005,1.0,0.0
9055,Autumn Sonata 2017 Re-release,11959,0,11959,2017,0.0,1.0
9056,The Strange Little Cat,11956,5885,6071,2014,0.4922214787554366,0.5077785212445634
9057,The Last Race,11947,11947,0,2018,1.0,0.0
9058,Frank Serpico,11925,11925,0,2017,1.0,0.0
9059,Yellow Asphalt,11907,11907,0,2002,1.0,0.0
9060,"Cassandro, The Exotico!",11897,11897,0,2019,1.0,0.0
9061,New York in the 50's,11882,11882,0,2001,1.0,0.0
9062,Smokers Only,11871,11871,0,2002,1.0,0.0
9063,Revenge of the Mekons,11861,11861,0,2014,1.0,0.0
9064,Les Parents Terribles,11818,11818,0,2018,1.0,0.0
9065,Janice Beard,11816,11816,0,2002,1.0,0.0
9066,Emptying the Skies,11811,11811,0,2015,1.0,0.0
9067,The Dry Land,11777,11777,0,2010,1.0,0.0
9068,Summer '03,11746,11746,0,2018,1.0,0.0
9069,Rid of Me,11740,11740,0,2011,1.0,0.0
9070,Writer of O,11728,11728,0,2005,1.0,0.0
9071,Lucha Mexico,11722,11722,0,2016,1.0,0.0
9072,White Wedding 2010 Re-release,11710,11710,0,2010,1.0,0.0
9073,My Voyage to Italy,11683,11683,0,2001,1.0,0.0
9074,36 Saints,11640,11640,0,2013,1.0,0.0
9075,The Tribes of Palos Verdes,11603,11603,0,2017,1.0,0.0
9076,11 Flowers,11599,9213,2386,2012,0.79429261143202,0.20570738856798
9077,Around India with a Movie Camera,11568,10389,1179,2018,0.8980809128630706,0.10191908713692946
9078,Crop Circles: Quest for Truth,11562,11562,0,2002,1.0,0.0
9079,Intoxicating,11560,11560,0,2004,1.0,0.0
9080,The Preppie Connection,11558,11558,0,2016,1.0,0.0
9081,River of Grass,11553,11553,0,2016,1.0,0.0
9082,The Ruins of Lifta,11548,11548,0,2016,1.0,0.0
9083,Ultrasuede: In Search of Halston,11539,11539,0,2012,1.0,0.0
9084,After the Cup: Sons of Sakhnin United,11538,11538,0,2010,1.0,0.0
9085,Girl Play,11523,11523,0,2005,1.0,0.0
9086,Elektra Luxx,11514,11514,0,2011,1.0,0.0
9087,Manfast,11480,11480,0,2003,1.0,0.0
9088,The Final Member,11428,11428,0,2014,1.0,0.0
9089,The Great Invisible,11428,11428,0,2014,1.0,0.0
9090,The Mesmerist,11422,11422,0,2002,1.0,0.0
9091,Love Forbidden 2003 Re-release,11421,11421,0,2003,1.0,0.0
9092,Beside Bowie: The Mick Ronson Story,11400,11400,0,2017,1.0,0.0
9093,Camera Obscura,11384,11384,0,2003,1.0,0.0
9094,Family Fundamentals,11344,11344,0,2002,1.0,0.0
9095,Rendezvous in July,11321,11321,0,2018,1.0,0.0
9096,Viktoria,11314,11314,0,2016,1.0,0.0
9097,Saigon Bodyguards,11314,11314,0,2017,1.0,0.0
9098,Cinemania,11305,11305,0,2003,1.0,0.0
9099,Dishkiyaoon,11288,11288,0,2014,1.0,0.0
9100,Theo Who Lived,11271,11271,0,2016,1.0,0.0
9101,Daylight's End,11257,0,11257,2016,0.0,1.0
9102,Bullitt County,11257,11257,0,2018,1.0,0.0
9103,In Like Flynn,11255,11255,0,2019,1.0,0.0
9104,Hacker,11239,11239,0,2016,1.0,0.0
9105,The Pathological Optimist,11222,11222,0,2017,1.0,0.0
9106,Children of Invention,11183,11183,0,2010,1.0,0.0
9107,Made Me Do It,11151,11151,0,2019,1.0,0.0
9108,"Now, Forager",11146,11146,0,2012,1.0,0.0
9109,InSight,11100,11100,0,2011,1.0,0.0
9110,Winning Girls Through Psychic Mind Control,11089,11089,0,2005,1.0,0.0
9111,Edward II 2018 Re-release,11055,4826,6229,2018,0.4365445499773858,0.5634554500226142
9112,The Challenge,11043,11043,0,2017,1.0,0.0
9113,The Woman with the 5 Elephants 2011 Re-release,11026,11026,0,2011,1.0,0.0
9114,Gasoline,11023,11023,0,2003,1.0,0.0
9115,PAY 2 PLAY: Democracy's High Stakes,11021,11021,0,2014,1.0,0.0
9116,Midget Zombie Takeover,11006,11006,0,2013,1.0,0.0
9117,Christina,11000,11000,0,2010,1.0,0.0
9118,Manito,11000,11000,0,2003,1.0,0.0
9119,Pauly Shore Is Dead,11000,11000,0,2004,1.0,0.0
9120,Suburban Birds,10997,10997,0,2019,1.0,0.0
9121,Just Before I Go,10970,10970,0,2015,1.0,0.0
9122,Digging Up the Marrow,10969,10969,0,2015,1.0,0.0
9123,Very Good Girls,10963,6940,4023,2014,0.6330384018972909,0.3669615981027091
9124,Wallander: Hämnden 2012 Re-release,10960,10960,0,2012,1.0,0.0
9125,Sarah Palin: You Betcha!,10935,10935,0,2011,1.0,0.0
9126,If the Dancer Dances,10912,10912,0,2019,1.0,0.0
9127,MC5*: A True Testimonial,10888,10888,0,2004,1.0,0.0
9128,Stardom,10886,10886,0,2000,1.0,0.0
9129,As It Is in Heaven,10850,10850,0,2014,1.0,0.0
9130,What Happened Last Night,10844,10844,0,2016,1.0,0.0
9131,The Forecaster,10824,10172,652,2015,0.9397634885439764,0.06023651145602365
9132,Bleeding Heart,10815,0,10815,2015,0.0,1.0
9133,Terkel in Trouble 2010 Re-release,10783,10783,0,2010,1.0,0.0
9134,The Man Who Shook the Hand of Vicente Fernandez,10782,10782,0,2012,1.0,0.0
9135,Vision Portraits,10771,10771,0,2019,1.0,0.0
9136,Mala Mala,10761,10761,0,2015,1.0,0.0
9137,A Resurrection,10730,10730,0,2013,1.0,0.0
9138,Hollow in the Land,10688,0,10688,2017,0.0,1.0
9139,Made in Cleveland,10681,10681,0,2013,1.0,0.0
9140,Frankie & Alice,10670,10670,0,2010,1.0,0.0
9141,National Bird,10656,10656,0,2016,1.0,0.0
9142,American Meat,10650,10650,0,2013,1.0,0.0
9143,Caucus,10645,10645,0,2013,1.0,0.0
9144,Mind the Gap,10637,10637,0,2004,1.0,0.0
9145,One More Round,10629,10629,0,2005,1.0,0.0
9146,Lovesong,10626,10626,0,2017,1.0,0.0
9147,Marriage Italian Style 2011 Re-release,10600,10600,0,2011,1.0,0.0
9148,Inside the Mind of Leonardo,10600,10600,0,2014,1.0,0.0
9149,Nola,10550,10550,0,2003,1.0,0.0
9150,China Heavyweight,10550,10550,0,2012,1.0,0.0
9151,Fighting Tommy Riley,10514,10514,0,2005,1.0,0.0
9152,Waiting for Armageddon,10501,10501,0,2010,1.0,0.0
9153,Clarence,10495,10495,0,2017,1.0,0.0
9154,Santa Mesa,10490,10490,0,2012,1.0,0.0
9155,Neon Flesh 2012 Re-release,10483,0,10483,2012,0.0,1.0
9156,"Norte, the End of History",10457,10457,0,2014,1.0,0.0
9157,Evil Intent,10454,10454,0,2013,1.0,0.0
9158,Class Rank,10452,10452,0,2018,1.0,0.0
9159,Let's Get Frank,10440,10440,0,2004,1.0,0.0
9160,Mama Africa 2018 Re-release,10430,10430,0,2018,1.0,0.0
9161,Love in the Time of Money,10410,10410,0,2002,1.0,0.0
9162,The Advocates,10402,10402,0,2018,1.0,0.0
9163,Shanghai Calling,10400,10400,0,2013,1.0,0.0
9164,Elemental,10358,10358,0,2013,1.0,0.0
9165,Zero Bridge,10357,10357,0,2011,1.0,0.0
9166,SK1 2016 Re-release,10330,10330,0,2016,1.0,0.0
9167,Oasis 2004 Re-release,10304,10304,0,2004,1.0,0.0
9168,Painted Woman,10298,10298,0,2017,1.0,0.0
9169,Shepard & Dark,10278,10278,0,2013,1.0,0.0
9170,Moebius,10254,2340,7914,2014,0.22820362785254536,0.7717963721474547
9171,The Endless Summer,10233,10233,0,2014,1.0,0.0
9172,Amelia 2.0,10233,10233,0,2017,1.0,0.0
9173,Approaching the Unknown,10232,10232,0,2016,1.0,0.0
9174,Tip Top,10201,6050,4151,2013,0.5930791098911872,0.4069208901088129
9175,When Lambs Become Lions,10197,9337,860,2019,0.9156614690595273,0.0843385309404727
9176,Prince of the Himalayas,10190,10190,0,2011,1.0,0.0
9177,Miss Minoes 2011 Re-release,10189,10189,0,2011,1.0,0.0
9178,A Bird of the Air,10152,10152,0,2011,1.0,0.0
9179,Revolution #9,10133,10133,0,2002,1.0,0.0
9180,Beta Test,10104,10104,0,2016,1.0,0.0
9181,Putin's Kiss,10082,10082,0,2012,1.0,0.0
9182,Pawn Shop Chronicles,10080,8088,1992,2013,0.8023809523809524,0.1976190476190476
9183,Before I Disappear,10078,10078,0,2014,1.0,0.0
9184,Little Accidents,10071,10071,0,2015,1.0,0.0
9185,Informant,10068,10068,0,2013,1.0,0.0
9186,The Sunshine Makers,10042,10042,0,2017,1.0,0.0
9187,Circle,10024,10024,0,2010,1.0,0.0
9188,The Life and Mind of Mark DeFriest,10021,10021,0,2015,1.0,0.0
9189,Arjun: The Warrior Prince,10017,10017,0,2012,1.0,0.0
9190,The Do-Deca-Pentathlon,10000,10000,0,2012,1.0,0.0
9191,"Hugh Hefner: Playboy, Activist and Rebel",10000,10000,0,2010,1.0,0.0
9192,Tere Bin Laden: Dead Or Alive,9995,0,9995,2016,0.0,1.0
9193,Made in France,9956,9956,0,2016,1.0,0.0
9194,Olivia,9934,9934,0,2019,1.0,0.0
9195,Streetwise,9904,9904,0,2019,1.0,0.0
9196,Take Care of My Cat,9866,9866,0,2002,1.0,0.0
9197,52 Tuesdays,9844,0,9844,2015,0.0,1.0
9198,Kabbalah Me,9816,9816,0,2014,1.0,0.0
9199,Down Terrace,9812,9812,0,2010,1.0,0.0
9200,Birth of the Living Dead,9802,9802,0,2013,1.0,0.0
9201,Cuba: Island of Music,9791,9791,0,2004,1.0,0.0
9202,Pelle the Conqueror 2017 Re-release,9757,9757,0,2017,1.0,0.0
9203,Finding Home,9736,9736,0,2005,1.0,0.0
9204,All the Rage,9730,9730,0,2000,1.0,0.0
9205,The President's Last Bang,9724,9724,0,2005,1.0,0.0
9206,"If You Don't, I Will",9719,9719,0,2014,1.0,0.0
9207,Antoine and Antoinette,9704,9704,0,2013,1.0,0.0
9208,Brutal Beauty: Tales of the Rose City Rollers,9677,9677,0,2010,1.0,0.0
9209,The Quest of Alain Ducasse,9627,9627,0,2018,1.0,0.0
9210,Virgin,9614,9614,0,2004,1.0,0.0
9211,The Spanish Prisoner 2019 Re-release,9589,9589,0,2019,1.0,0.0
9212,Vito Bonafacci,9570,9570,0,2011,1.0,0.0
9213,Chosen,9536,9283,253,2016,0.9734689597315436,0.026531040268456377
9214,The Lost Arcade,9522,9522,0,2016,1.0,0.0
9215,Strangers on the Earth,9518,9518,0,2018,1.0,0.0
9216,Living Proof,9512,9512,0,2017,1.0,0.0
9217,In the House of Flies,9480,9480,0,2014,1.0,0.0
9218,Claire Dolan,9480,9480,0,2000,1.0,0.0
9219,Northern Lights,9453,9453,0,2013,1.0,0.0
9220,If I Were You,9432,9432,0,2013,1.0,0.0
9221,I'll Sing for You 2004 Re-release,9425,9425,0,2004,1.0,0.0
9222,Zero Charisma,9417,9417,0,2013,1.0,0.0
9223,"One Cut, One Life",9406,9406,0,2015,1.0,0.0
9224,"L'Chayim, Comrade Stalin",9397,9397,0,2003,1.0,0.0
9225,Innocence and Experience: The Making of 'The Age of Innocence',9395,9395,0,2005,1.0,0.0
9226,First Love 2005 Re-release,9392,9392,0,2005,1.0,0.0
9227,Miss Kiet's Children 2017 Re-release,9384,9384,0,2017,1.0,0.0
9228,Acts of Worship,9377,9377,0,2003,1.0,0.0
9229,The Tree of Wooden Clogs,9367,0,9367,2016,0.0,1.0
9230,Radio Free Albemuth,9365,9365,0,2014,1.0,0.0
9231,Fritz Lang's Indian Epic 2019 re-release,9345,9345,0,2019,1.0,0.0
9232,The End of Love,9342,9342,0,2013,1.0,0.0
9233,Looking for Maria Sanchez,9338,9338,0,2013,1.0,0.0
9234,Milk and Honey,9331,9331,0,2005,1.0,0.0
9235,The Immortalists,9331,9331,0,2014,1.0,0.0
9236,Better Mus' Come,9318,9318,0,2013,1.0,0.0
9237,Wonderful World,9309,9309,0,2010,1.0,0.0
9238,The City Dark,9269,9269,0,2012,1.0,0.0
9239,Hooligan Sparrow,9263,9263,0,2016,1.0,0.0
9240,The Sacrament,9221,9221,0,2014,1.0,0.0
9241,A Dark Place,9212,0,9212,2019,0.0,1.0
9242,Cracked Up,9197,9197,0,2019,1.0,0.0
9243,Ghost Team One,9195,9195,0,2013,1.0,0.0
9244,Trouble Every Day 2013 Re-release,9189,9189,0,2013,1.0,0.0
9245,Frank & Lola,9188,9188,0,2016,1.0,0.0
9246,The Young Girl and the Monsoon,9186,9186,0,2001,1.0,0.0
9247,The Hollow Point,9149,0,9149,2016,0.0,1.0
9248,Thirst Street,9129,9129,0,2017,1.0,0.0
9249,Cupcakes,9129,9129,0,2015,1.0,0.0
9250,The Ardennes 2016 Re-release,9116,5638,3478,2016,0.6184730144800351,0.3815269855199649
9251,Faith Connections,9111,9111,0,2014,1.0,0.0
9252,Lycan,9110,9110,0,2017,1.0,0.0
9253,The Eyes,9104,9104,0,2017,1.0,0.0
9254,Julian Schnabel: A Private Portrait,9103,9103,0,2017,1.0,0.0
9255,Decoding Deepak,9100,9100,0,2012,1.0,0.0
9256,Il Posto,9080,9080,0,2002,1.0,0.0
9257,Gerontophilia 2015 Re-release,9074,4916,4158,2015,0.541767687899493,0.45823231210050697
9258,El Mar La Mar,9065,9065,0,2018,1.0,0.0
9259,Living Life,9064,9064,0,2005,1.0,0.0
9260,Frantz Fanon: Black Skin White Mask,9025,9025,0,2019,1.0,0.0
9261,Step Up: High Water,9005,9005,0,2018,1.0,0.0
9262,Money Fight,9004,9004,0,2012,1.0,0.0
9263,Station to Station,9000,9000,0,2015,1.0,0.0
9264,Mosquita y Mari,9000,9000,0,2012,1.0,0.0
9265,Zoo Wars,8998,8998,0,2018,1.0,0.0
9266,Revolt,8986,0,8986,2017,0.0,1.0
9267,Survivors Guide To Prison,8982,8982,0,2018,1.0,0.0
9268,Colossal Youth,8968,8331,637,2018,0.9289696699375558,0.07103033006244425
9269,Big Words,8965,8965,0,2013,1.0,0.0
9270,Three Stars,8942,8942,0,2012,1.0,0.0
9271,Summer of '67,8941,8941,0,2018,1.0,0.0
9272,This is Congo,8905,7051,1854,2018,0.7918023582257159,0.2081976417742841
9273,B-Side,8870,8870,0,2015,1.0,0.0
9274,The Swenkas,8860,8860,0,2005,1.0,0.0
9275,Missing Young Woman,8858,8858,0,2003,1.0,0.0
9276,The Meanest Man in Texas,8850,8850,0,2019,1.0,0.0
9277,The Pardon,8845,8845,0,2015,1.0,0.0
9278,Providence,8840,8840,0,2016,1.0,0.0
9279,Home Run Showdown,8824,8824,0,2012,1.0,0.0
9280,That Part Feeling - the Universe of Arvo Part,8812,8812,0,2019,1.0,0.0
9281,The Cabinet of Dr. Caligari 2014 Re-release,8811,8811,0,2014,1.0,0.0
9282,Dawn of the Crescent Moon,8799,8799,0,2015,1.0,0.0
9283,Hell Baby,8785,8785,0,2013,1.0,0.0
9284,Bounce: Behind the Velvet Rope,8779,8779,0,2001,1.0,0.0
9285,Evil Remains,8747,8747,0,2004,1.0,0.0
9286,Everything Put Together,8741,2963,5778,2001,0.33897723372611827,0.6610227662738817
9287,Only When I Dance,8738,8738,0,2010,1.0,0.0
9288,The Man in the White Suit,8718,8718,0,2012,1.0,0.0
9289,Blood Feast,8708,8708,0,2018,1.0,0.0
9290,Amnesia,8700,8700,0,2017,1.0,0.0
9291,Man on a Mission: Richard Garriott's Road to the Stars,8688,8688,0,2012,1.0,0.0
9292,"Small, Beautifully Moving Parts",8631,8631,0,2012,1.0,0.0
9293,Meet Me in Montenegro,8612,8612,0,2015,1.0,0.0
9294,Almost Human,8608,8447,161,2014,0.981296468401487,0.018703531598513012
9295,Mojave,8602,8253,349,2016,0.9594280399906998,0.04057196000930016
9296,Farewell to Hollywood,8601,8601,0,2015,1.0,0.0
9297,General Education,8601,8601,0,2012,1.0,0.0
9298,Kaena: The Prophecy 2004 Re-release,8593,8593,0,2004,1.0,0.0
9299,Lucky,8564,8564,0,2011,1.0,0.0
9300,From the East,8540,8540,0,2016,1.0,0.0
9301,Inspector Maigret,8528,8528,0,2017,1.0,0.0
9302,The Quitter,8512,8512,0,2014,1.0,0.0
9303,The Empty Hours,8478,8244,234,2014,0.9723991507430998,0.027600849256900213
9304,Furlough,8472,8472,0,2018,1.0,0.0
9305,Zero Day,8466,8466,0,2003,1.0,0.0
9306,Canopy,8462,8462,0,2014,1.0,0.0
9307,The Institute,8445,8445,0,2013,1.0,0.0
9308,We Are the Flesh,8438,8438,0,2017,1.0,0.0
9309,Hello Herman,8437,8437,0,2013,1.0,0.0
9310,Red Hollywood,8426,8426,0,2014,1.0,0.0
9311,The Happy Sad,8395,8395,0,2013,1.0,0.0
9312,Downloaded,8377,8377,0,2013,1.0,0.0
9313,Counting,8374,8374,0,2015,1.0,0.0
9314,Gilbert,8362,8362,0,2017,1.0,0.0
9315,The Rising Place,8360,8360,0,2002,1.0,0.0
9316,Eternity: The Movie,8350,8350,0,2014,1.0,0.0
9317,Gringo Trails,8349,8349,0,2014,1.0,0.0
9318,A Teacher,8348,8348,0,2013,1.0,0.0
9319,Natasha,8325,8325,0,2017,1.0,0.0
9320,The Dead Center,8320,8320,0,2019,1.0,0.0
9321,About Cherry,8315,3003,5312,2012,0.36115453998797353,0.6388454600120265
9322,Mr. Chibbs,8302,8302,0,2017,1.0,0.0
9323,Served Like a Girl,8290,8290,0,2017,1.0,0.0
9324,We Are Twisted Fucking Sister!,8277,8277,0,2016,1.0,0.0
9325,Life Partners,8265,8265,0,2014,1.0,0.0
9326,Aliyah,8253,8253,0,2013,1.0,0.0
9327,Silicon Cowboys,8239,8239,0,2016,1.0,0.0
9328,Brooklyn Brothers Beat the Best,8210,7466,744,2012,0.9093788063337394,0.09062119366626066
9329,Spiral,8190,8190,0,2018,1.0,0.0
9330,Jellyfish Eyes,8176,8176,0,2015,1.0,0.0
9331,Anatahan,8171,8171,0,2017,1.0,0.0
9332,Suspended Animation,8169,8169,0,2003,1.0,0.0
9333,The Other Side,8168,8074,94,2016,0.9884916748285995,0.011508325171400588
9334,Far from Vietnam,8132,8132,0,2013,1.0,0.0
9335,Twist of Faith,8129,8129,0,2005,1.0,0.0
9336,From Nowhere,8109,8109,0,2017,1.0,0.0
9337,Restless City,8100,8100,0,2012,1.0,0.0
9338,Next Year Jerusalem,8093,8093,0,2014,1.0,0.0
9339,In the Mirror of Maya Deren,8077,8077,0,2003,1.0,0.0
9340,Golden Kingdom,8077,8077,0,2016,1.0,0.0
9341,16 Years of Alcohol,8046,8046,0,2005,1.0,0.0
9342,No Turning Back,8042,8042,0,2003,1.0,0.0
9343,Steak (R)evolution,8038,8025,13,2015,0.9983826822592685,0.0016173177407315252
9344,Straight Outta Tompkins,8022,8022,0,2015,1.0,0.0
9345,Occupation: Dreamland,8018,8018,0,2005,1.0,0.0
9346,The Scoundrel's Wife,8018,8018,0,2003,1.0,0.0
9347,Talent Has Hunger,7998,7998,0,2016,1.0,0.0
9348,All About Evil,7995,7995,0,2010,1.0,0.0
9349,One Small Hitch 2015 Re-release,7965,7965,0,2015,1.0,0.0
9350,Roseanne for President!,7960,7960,0,2016,1.0,0.0
9351,Stolen,7943,7943,0,2010,1.0,0.0
9352,A Decent Factory,7925,7925,0,2005,1.0,0.0
9353,Mugabe and the White African,7924,7924,0,2010,1.0,0.0
9354,Angels Are Made Of Light,7919,7919,0,2019,1.0,0.0
9355,Portrait of a Garden,7914,7914,0,2016,1.0,0.0
9356,Bleak Street,7888,0,7888,2015,0.0,1.0
9357,This Magnificent Cake!,7888,7888,0,2019,1.0,0.0
9358,Swept Away,7876,7876,0,2017,1.0,0.0
9359,Zenith,7862,7862,0,2010,1.0,0.0
9360,The Ballad of Lefty Brown,7856,7856,0,2017,1.0,0.0
9361,Ghost Fleet,7850,7850,0,2019,1.0,0.0
9362,Prince of Central Park,7838,7838,0,2000,1.0,0.0
9363,Roadie,7825,7825,0,2012,1.0,0.0
9364,Photographic Memory,7822,7822,0,2012,1.0,0.0
9365,The Great Man,7814,7814,0,2015,1.0,0.0
9366,Archipelago 2014 Re-release,7791,7791,0,2014,1.0,0.0
9367,The Plagiarists,7768,7768,0,2019,1.0,0.0
9368,Old Stone,7768,7476,292,2016,0.962409886714727,0.03759011328527292
9369,And While We Were Here,7750,7750,0,2013,1.0,0.0
9370,Come Back to Me,7744,7744,0,2014,1.0,0.0
9371,Young Ones,7740,0,7740,2014,0.0,1.0
9372,Gregory's Girl,7710,7710,0,2019,1.0,0.0
9373,Maurizio Cattelan: Be Right Back,7706,7706,0,2017,1.0,0.0
9374,I Don't Belong Anywhere: The Cinema of Chantal Akerman,7703,7703,0,2016,1.0,0.0
9375,Witness for the Prosecution,7693,0,7693,2003,0.0,1.0
9376,I'll Take Your Dead,7692,7692,0,2019,1.0,0.0
9377,With All Deliberate Speed,7690,7690,0,2004,1.0,0.0
9378,Running Shaadi,7674,0,7674,2017,0.0,1.0
9379,Last Days Here,7643,7643,0,2012,1.0,0.0
9380,Legend of the Mountain,7640,7640,0,2018,1.0,0.0
9381,Wasabi Tuna,7631,7631,0,2004,1.0,0.0
9382,Psycho Raman,7612,0,7612,2016,0.0,1.0
9383,Area 51,7556,7556,0,2015,1.0,0.0
9384,The Wrong Light,7553,7553,0,2017,1.0,0.0
9385,Controlled Chaos,7549,7549,0,2003,1.0,0.0
9386,Tales from the Script,7535,7535,0,2010,1.0,0.0
9387,Girls Against Boys,7529,7529,0,2013,1.0,0.0
9388,Birthright: A War Story,7519,7519,0,2017,1.0,0.0
9389,Udaan,7461,7461,0,2010,1.0,0.0
9390,The Little Bedroom 2014 Re-release,7440,7440,0,2014,1.0,0.0
9391,Raze,7429,7429,0,2014,1.0,0.0
9392,Bel Borba Aqui,7426,7426,0,2012,1.0,0.0
9393,The Dogwalker,7420,7420,0,2002,1.0,0.0
9394,Rubble Kings,7416,7416,0,2015,1.0,0.0
9395,Price Check,7413,7413,0,2012,1.0,0.0
9396,The Giant Mechanical Man,7396,7396,0,2012,1.0,0.0
9397,Silent Waters,7384,7384,0,2004,1.0,0.0
9398,Desperate Acts of Magic,7373,7373,0,2013,1.0,0.0
9399,Gendernauts: A Journey Through Shifting Identities,7358,7358,0,2000,1.0,0.0
9400,Big Time,7347,7347,0,2017,1.0,0.0
9401,Shoah: Four Sisters,7323,7323,0,2018,1.0,0.0
9402,Beloved Beast,7301,7301,0,2019,1.0,0.0
9403,Dangerous Ishq,7298,0,7298,2012,0.0,1.0
9404,A Piece of Eden,7296,7296,0,2000,1.0,0.0
9405,Gangster's Paradise: Jerusalema 2010 Re-release,7294,7294,0,2010,1.0,0.0
9406,Another WolfCop,7285,7285,0,2017,1.0,0.0
9407,Group,7281,7281,0,2002,1.0,0.0
9408,Indian Point,7251,7251,0,2016,1.0,0.0
9409,Outside Satan,7226,0,7226,2013,0.0,1.0
9410,Tall: The American Skyscraper and Louis Sullivan,7216,7216,0,2018,1.0,0.0
9411,Wake,7212,7212,0,2004,1.0,0.0
9412,I Am Ali,7205,7205,0,2014,1.0,0.0
9413,London River 2011 Re-release,7200,7200,0,2011,1.0,0.0
9414,Happiness Runs,7199,7199,0,2010,1.0,0.0
9415,Antarctic Edge: 70° South,7193,7193,0,2015,1.0,0.0
9416,The Strange Color of Your Body's Tears,7182,7182,0,2014,1.0,0.0
9417,ABCs of Death 2,7171,7171,0,2014,1.0,0.0
9418,It Had to Be You,7162,7162,0,2016,1.0,0.0
9419,"Brutti, sporchi e cattivi",7144,7144,0,2016,1.0,0.0
9420,Logan,7137,7137,0,2010,1.0,0.0
9421,The Reagan Show,7109,5500,1609,2017,0.7736671824447883,0.2263328175552117
9422,Domain 2012 Re-release,7105,7105,0,2012,1.0,0.0
9423,The Jazz Funeral,7103,7103,0,2017,1.0,0.0
9424,The Dark Below,7095,7095,0,2017,1.0,0.0
9425,Painless,7082,7082,0,2018,1.0,0.0
9426,Stage Fright,7078,7078,0,2014,1.0,0.0
9427,Good Neighbours,7072,7072,0,2011,1.0,0.0
9428,In Echo Park,7072,7072,0,2018,1.0,0.0
9429,The Brainwashing of My Dad,7028,7028,0,2016,1.0,0.0
9430,In the Land of Pomegranates,7014,7014,0,2018,1.0,0.0
9431,Corman's World: Exploits of a Hollywood Rebel,7000,7000,0,2011,1.0,0.0
9432,Aristide and the Endless Revolution,6998,6998,0,2005,1.0,0.0
9433,The Brass Teapot,6997,6997,0,2013,1.0,0.0
9434,Gabriel,6959,6959,0,2015,1.0,0.0
9435,"Love, Marilyn",6950,6950,0,2012,1.0,0.0
9436,Los Angeles Plays Itself,6945,6945,0,2004,1.0,0.0
9437,A Kind of Loving,6912,6912,0,2017,1.0,0.0
9438,Assaulted: Civil Rights Under Fire,6905,6905,0,2013,1.0,0.0
9439,Boom Bust Boom,6896,6896,0,2016,1.0,0.0
9440,Misconceptions,6892,6892,0,2010,1.0,0.0
9441,Sal,6883,6883,0,2013,1.0,0.0
9442,The Human Scale,6878,6878,0,2013,1.0,0.0
9443,Duck Butter,6877,6877,0,2018,1.0,0.0
9444,The Sisterhood of Night,6870,6870,0,2015,1.0,0.0
9445,Last Ride 2012 Re-release,6853,6853,0,2012,1.0,0.0
9446,Pursuit of Happiness,6850,6850,0,2003,1.0,0.0
9447,Janie Jones,6840,6840,0,2011,1.0,0.0
9448,Mad Tiger,6823,6823,0,2016,1.0,0.0
9449,"No God, No Master",6796,6796,0,2014,1.0,0.0
9450,Finding Bliss,6783,6783,0,2010,1.0,0.0
9451,Mercy,6780,6780,0,2010,1.0,0.0
9452,Calling All Earthlings,6756,6756,0,2018,1.0,0.0
9453,Dying to Survive 2019 Re-release,6752,6752,0,2019,1.0,0.0
9454,A Whale of a Tale,6747,6747,0,2018,1.0,0.0
9455,Buddha Heads,6739,6739,0,2002,1.0,0.0
9456,Iceman,6719,2138,4581,2018,0.3182021134097336,0.6817978865902664
9457,Before You Know It,6717,6717,0,2014,1.0,0.0
9458,The Phantom of Liberty,6686,6172,514,2002,0.9231229434639545,0.07687705653604547
9459,Regina Spektor Live in London,6684,6684,0,2010,1.0,0.0
9460,"Arabian Nights - Volume 3, The Enchanted One",6681,4502,2179,2015,0.6738512198772639,0.3261487801227361
9461,Footnotes 2017 Re-release,6660,6660,0,2017,1.0,0.0
9462,Ghost Team,6639,6639,0,2016,1.0,0.0
9463,The Persian Connection,6634,6634,0,2017,1.0,0.0
9464,Breakfast with Curtis,6629,6629,0,2013,1.0,0.0
9465,The Dying of the Light,6627,6627,0,2016,1.0,0.0
9466,Aatsinki: The Story of Arctic Cowboys,6601,6601,0,2014,1.0,0.0
9467,Brief Reunion,6601,6601,0,2013,1.0,0.0
9468,Down the Shore,6558,6558,0,2013,1.0,0.0
9469,Master of the Game,6554,6554,0,2004,1.0,0.0
9470,In Our Nature,6543,6543,0,2012,1.0,0.0
9471,Elizabeth Blue,6542,6542,0,2017,1.0,0.0
9472,Dream Boy,6534,6534,0,2010,1.0,0.0
9473,The Aggressives,6533,6533,0,2005,1.0,0.0
9474,Bloody Angels,6509,6509,0,2001,1.0,0.0
9475,Horse Money,6508,6508,0,2015,1.0,0.0
9476,Jews of Egypt,6505,6505,0,2014,1.0,0.0
9477,The Last Place on Earth,6505,6505,0,2004,1.0,0.0
9478,Windfall,6504,6504,0,2012,1.0,0.0
9479,Ride,6489,0,6489,2015,0.0,1.0
9480,The Beat Hotel,6480,6480,0,2012,1.0,0.0
9481,Santa santita,6470,6470,0,2005,1.0,0.0
9482,Scum,6461,6461,0,2017,1.0,0.0
9483,"White King, Red Rubber, Black Death",6458,6458,0,2005,1.0,0.0
9484,McLibel,6450,4337,2113,2005,0.6724031007751938,0.3275968992248062
9485,Tu Dors Nicole,6445,5662,783,2015,0.8785104732350659,0.12148952676493406
9486,The Suicide Theory,6434,6434,0,2015,1.0,0.0
9487,Some Velvet Morning,6420,6420,0,2013,1.0,0.0
9488,100 Bloody Acres,6388,6388,0,2013,1.0,0.0
9489,Forty Guns,6344,0,6344,2002,0.0,1.0
9490,Inescapable,6334,6334,0,2013,1.0,0.0
9491,The Charnel House,6332,6332,0,2016,1.0,0.0
9492,Watercolors,6305,6305,0,2010,1.0,0.0
9493,Manuscripts Don't Burn,6295,6295,0,2014,1.0,0.0
9494,Under the Eiffel Tower,6291,6291,0,2019,1.0,0.0
9495,Solitude,6260,6260,0,2005,1.0,0.0
9496,The Skyjacker's Tale,6253,6253,0,2017,1.0,0.0
9497,All My Loved Ones,6237,6237,0,2002,1.0,0.0
9498,One Last Thing,6232,6232,0,2018,1.0,0.0
9499,In the Steps of Trisha Brown,6230,6230,0,2017,1.0,0.0
9500,The Bad Kids,6226,6226,0,2016,1.0,0.0
9501,A Man Vanishes 2012 Re-release,6201,6201,0,2012,1.0,0.0
9502,The Red Chapel,6196,6196,0,2010,1.0,0.0
9503,The Night of the Shooting Stars 2015 Re-release,6186,6186,0,2015,1.0,0.0
9504,Forget Baghdad: Jews and Arabs - The Iraqi Connection,6151,3741,2410,2003,0.6081937896277028,0.3918062103722972
9505,Sweetwater,6147,6147,0,2013,1.0,0.0
9506,Crazy Eyes,6141,6141,0,2012,1.0,0.0
9507,Relaxer,6133,6133,0,2019,1.0,0.0
9508,Guitar Innovators: John Fahey & Nels Cline,6132,6132,0,2013,1.0,0.0
9509,"El Sicario, Room 164",6123,6123,0,2011,1.0,0.0
9510,Scottsboro: An American Tragedy,6123,6123,0,2001,1.0,0.0
9511,Welcome to Pine Hill,6115,6115,0,2013,1.0,0.0
9512,Arise from Darkness,6112,6112,0,2017,1.0,0.0
9513,Rangrezz,6108,6108,0,2013,1.0,0.0
9514,The Last Fall,6100,6100,0,2012,1.0,0.0
9515,The Last Time I Saw Macao,6095,6095,0,2013,1.0,0.0
9516,The Calling 2003 Re-release,6092,6092,0,2003,1.0,0.0
9517,The Fuzz,6067,6067,0,2017,1.0,0.0
9518,The Miners' Hymns,6051,6051,0,2012,1.0,0.0
9519,The Marquise of O,6048,6048,0,2015,1.0,0.0
9520,Love & Air Sex,6047,6047,0,2014,1.0,0.0
9521,The Family Tree,6035,6035,0,2011,1.0,0.0
9522,Love Object,6028,6028,0,2004,1.0,0.0
9523,BearCity,6000,6000,0,2010,1.0,0.0
9524,Rat,5980,2630,3350,2001,0.4397993311036789,0.560200668896321
9525,On Wings of Eagles 2017 Re-release,5975,5975,0,2017,1.0,0.0
9526,"Sex, Death and Bowling",5972,5972,0,2015,1.0,0.0
9527,The Playroom,5964,5964,0,2013,1.0,0.0
9528,Cavemen,5948,5948,0,2014,1.0,0.0
9529,Starless Dreams,5937,5937,0,2017,1.0,0.0
9530,American Animal,5928,5928,0,2012,1.0,0.0
9531,Sweethearts of the Prison Rodeo,5922,5922,0,2010,1.0,0.0
9532,I Am MLK Jr.,5918,5918,0,2018,1.0,0.0
9533,Gang of Ghosts,5906,5906,0,2014,1.0,0.0
9534,Slash,5902,5902,0,2016,1.0,0.0
9535,Medeas,5895,5895,0,2015,1.0,0.0
9536,An Actor Prepares,5891,1743,4148,2018,0.2958750636564251,0.704124936343575
9537,Infliction,5875,5875,0,2014,1.0,0.0
9538,The Imperialists Are Still Alive!,5874,5874,0,2011,1.0,0.0
9539,Empire of Silver 2011 Re-release,5867,0,5867,2011,0.0,1.0
9540,BuzzKill,5860,5860,0,2012,1.0,0.0
9541,Top Spin,5858,5858,0,2015,1.0,0.0
9542,Bourek,5844,5844,0,2016,1.0,0.0
9543,Shout Gladi Gladi,5839,5839,0,2015,1.0,0.0
9544,Strike! 2000 Re-release,5838,5838,0,2000,1.0,0.0
9545,Bad Blood,5812,5812,0,2001,1.0,0.0
9546,Emile,5799,5799,0,2005,1.0,0.0
9547,Five Dances,5788,5788,0,2013,1.0,0.0
9548,Black November,5782,5782,0,2015,1.0,0.0
9549,Undrafted,5777,5777,0,2016,1.0,0.0
9550,Sushi: The Global Catch,5757,5757,0,2012,1.0,0.0
9551,A Dark Truth,5750,5750,0,2013,1.0,0.0
9552,The Overture 2005 Re-release,5740,2254,3486,2005,0.3926829268292683,0.6073170731707317
9553,Dream,5729,5729,0,2005,1.0,0.0
9554,Klezmer on Fish Street,5724,5724,0,2004,1.0,0.0
9555,Save the Date,5719,5719,0,2012,1.0,0.0
9556,The Wanted 18,5680,5680,0,2015,1.0,0.0
9557,People of a Feather,5677,5677,0,2013,1.0,0.0
9558,The Fall of Night,5673,5673,0,2010,1.0,0.0
9559,Knife Fight,5661,5661,0,2013,1.0,0.0
9560,Papirosen,5658,5658,0,2014,1.0,0.0
9561,This Isn't Funny,5654,5654,0,2015,1.0,0.0
9562,The Roost,5642,5642,0,2005,1.0,0.0
9563,Série noire,5633,5633,0,2019,1.0,0.0
9564,La Chinoise 2017 Re-release,5631,5631,0,2017,1.0,0.0
9565,Elevate,5580,5580,0,2011,1.0,0.0
9566,Our Man in Tehran,5573,5573,0,2015,1.0,0.0
9567,Kid Cannabis,5565,5565,0,2014,1.0,0.0
9568,The Miracle of the Little Prince,5553,5553,0,2019,1.0,0.0
9569,Booker's Place: A Mississippi Story,5549,5549,0,2012,1.0,0.0
9570,American Grindhouse,5529,5529,0,2010,1.0,0.0
9571,Are We Not Cats,5518,5518,0,2018,1.0,0.0
9572,The Living,5514,5514,0,2015,1.0,0.0
9573,Icaros: A Vision,5510,5510,0,2017,1.0,0.0
9574,The First $20 Million Is Always the Hardest,5491,5491,0,2002,1.0,0.0
9575,The Man from Earth: Holocene,5472,5472,0,2017,1.0,0.0
9576,Quattro Noza,5471,5471,0,2005,1.0,0.0
9577,Coming Soon,5453,5453,0,2000,1.0,0.0
9578,Cuban Food Stories,5434,5434,0,2018,1.0,0.0
9579,Flex Is Kings,5418,5418,0,2014,1.0,0.0
9580,Whiz Kids,5386,5386,0,2010,1.0,0.0
9581,The Only Real Game,5384,5384,0,2014,1.0,0.0
9582,Particles of Truth,5348,5348,0,2004,1.0,0.0
9583,"La Commune (Paris, 1871)",5340,5340,0,2003,1.0,0.0
9584,She's Lost Control,5319,5319,0,2015,1.0,0.0
9585,The Time Being,5274,5274,0,2013,1.0,0.0
9586,It's Not Yet Dark,5269,1227,4042,2017,0.2328715126209907,0.7671284873790093
9587,Killers,5248,0,5248,2014,0.0,1.0
9588,Sarajevo,5247,5247,0,2015,1.0,0.0
9589,Speed-Dating,5240,5240,0,2010,1.0,0.0
9590,Home Room,5216,5216,0,2003,1.0,0.0
9591,The Princess of France,5212,5212,0,2015,1.0,0.0
9592,Death Valley,5211,5211,0,2015,1.0,0.0
9593,In Searching,5210,5210,0,2018,1.0,0.0
9594,Chokehold,5200,5200,0,2019,1.0,0.0
9595,The Gliksmans,5166,5166,0,2019,1.0,0.0
9596,"Vendetta: No Conscience, No Mercy",5161,5161,0,2003,1.0,0.0
9597,Lakeboat,5159,5159,0,2001,1.0,0.0
9598,And They're Off,5154,5154,0,2011,1.0,0.0
9599,100 Acres of Hell,5152,5152,0,2019,1.0,0.0
9600,To Die Is Hard,5129,5129,0,2010,1.0,0.0
9601,Body at Brighton Rock,5123,5123,0,2019,1.0,0.0
9602,Return to Nuke 'Em High Volume 1,5122,5122,0,2014,1.0,0.0
9603,Intersection,5116,5116,0,2018,1.0,0.0
9604,Bad Lucky Goat,5088,5088,0,2017,1.0,0.0
9605,On War 2015 Re-release,5086,5086,0,2015,1.0,0.0
9606,Welcome to Happiness,5083,5083,0,2016,1.0,0.0
9607,2307: Winter's Dream,5078,0,5078,2017,0.0,1.0
9608,Bidder 70,5074,5074,0,2013,1.0,0.0
9609,Tanner Hall,5073,5073,0,2011,1.0,0.0
9610,Notes on an Appearance,5065,5065,0,2018,1.0,0.0
9611,Chulas Fronteras,5021,5021,0,2019,1.0,0.0
9612,The Sleepwalker,5012,5012,0,2014,1.0,0.0
9613,Downtown Express,5010,5010,0,2012,1.0,0.0
9614,The Texture of Falling,5010,5010,0,2018,1.0,0.0
9615,Social Animals,5007,5007,0,2018,1.0,0.0
9616,The Garden,5006,5006,0,2019,1.0,0.0
9617,An L.A. Minute,5004,5004,0,2018,1.0,0.0
9618,Perfect Pie,5000,5000,0,2002,1.0,0.0
9619,Newlyweds,5000,5000,0,2012,1.0,0.0
9620,Weekend of a Champion,4976,4100,876,2013,0.8239549839228296,0.1760450160771704
9621,Bringing Up Bobby,4975,4975,0,2012,1.0,0.0
9622,sxtape,4961,0,4961,2014,0.0,1.0
9623,Futaba kara tooku hanarete,4960,4960,0,2013,1.0,0.0
9624,Herman's House,4956,4956,0,2013,1.0,0.0
9625,To Die Like a Man,4955,4029,926,2011,0.8131180625630676,0.1868819374369324
9626,SBK: The Movie,4950,4950,0,2015,1.0,0.0
9627,Tournament,4942,4942,0,2017,1.0,0.0
9628,Company Town,4934,4934,0,2017,1.0,0.0
9629,"Peace, Propaganda & the Promised Land",4930,4930,0,2005,1.0,0.0
9630,Supporting Characters,4917,4917,0,2013,1.0,0.0
9631,Guidance,4900,4900,0,2015,1.0,0.0
9632,Malek,4898,4898,0,2019,1.0,0.0
9633,Home of the Brave,4874,4874,0,2004,1.0,0.0
9634,Revelation Road 2: The Sea of Glass and Fire,4871,4871,0,2013,1.0,0.0
9635,Nothing Bad Can Happen,4870,4870,0,2014,1.0,0.0
9636,Kira's Reason: A Love Story,4847,4847,0,2003,1.0,0.0
9637,Call Her Applebroog,4842,4842,0,2016,1.0,0.0
9638,High Times Potluck,4827,4827,0,2003,1.0,0.0
9639,Ferlinghetti: A Rebirth of Wonder,4816,4816,0,2013,1.0,0.0
9640,"Half The Road: The Passion, Pitfalls & Power of Women's Professional Cycling",4783,4783,0,2014,1.0,0.0
9641,Perlasca,4780,4780,0,2005,1.0,0.0
9642,Behind the White Glasses,4770,2223,2547,2016,0.4660377358490566,0.5339622641509434
9643,Secret Society,4725,4725,0,2002,1.0,0.0
9644,Miss Hill: Making Dance Matter,4706,4706,0,2015,1.0,0.0
9645,Shot,4701,4701,0,2017,1.0,0.0
9646,Marinoni: The Fire in the Frame,4696,4696,0,2016,1.0,0.0
9647,The Other Side of Everything,4685,4685,0,2018,1.0,0.0
9648,Isn't This a Time! A Tribute Concert for Harold Leventhal,4683,4683,0,2005,1.0,0.0
9649,Death Metal Angola,4674,4674,0,2014,1.0,0.0
9650,The Long Dumb Road,4667,4667,0,2018,1.0,0.0
9651,Blood on the Mountain,4664,4664,0,2016,1.0,0.0
9652,Night School,4663,4663,0,2017,1.0,0.0
9653,I Love You Both,4661,4661,0,2017,1.0,0.0
9654,How to Draw a Bunny,4658,4658,0,2004,1.0,0.0
9655,Shakespeare-Wallah,4650,4650,0,2017,1.0,0.0
9656,Against the Sun,4646,4646,0,2015,1.0,0.0
9657,Seeds of Time,4630,4630,0,2015,1.0,0.0
9658,Miss Stevens,4611,4611,0,2016,1.0,0.0
9659,Chaos,4608,4608,0,2003,1.0,0.0
9660,The Automatic Hate,4603,4603,0,2016,1.0,0.0
9661,Protector 2010 Re-release,4576,2968,1608,2010,0.6486013986013986,0.3513986013986014
9662,Search Party 2016 Re-release,4571,4571,0,2016,1.0,0.0
9663,Smiling Through the Apocalypse,4560,4560,0,2014,1.0,0.0
9664,All Is Bright,4556,4556,0,2013,1.0,0.0
9665,A Boy Called Po,4550,4550,0,2017,1.0,0.0
9666,Promised Lands,4546,4546,0,2010,1.0,0.0
9667,Here Comes the Devil,4534,4534,0,2013,1.0,0.0
9668,Weightless,4530,4461,69,2018,0.9847682119205298,0.015231788079470199
9669,Unrelated 2014 Re-release,4529,4529,0,2014,1.0,0.0
9670,Synchronicity,4505,4505,0,2016,1.0,0.0
9671,The Pulitzer at 100,4489,4489,0,2017,1.0,0.0
9672,I'm Leaving Now,4488,4488,0,2019,1.0,0.0
9673,German Concentration Camps Factual Survey,4468,4468,0,2017,1.0,0.0
9674,"Farewell, Herr Schwarz",4445,4445,0,2015,1.0,0.0
9675,Generation Iron 2,4439,4439,0,2017,1.0,0.0
9676,Sacred Stage: The Mariinsky Theater,4410,4410,0,2005,1.0,0.0
9677,SGT. Will Gardner,4405,4405,0,2019,1.0,0.0
9678,The Truth About Emanuel,4404,4404,0,2014,1.0,0.0
9679,The Peacemaker,4400,4400,0,2018,1.0,0.0
9680,30-LOVE,4392,4392,0,2017,1.0,0.0
9681,Open My Heart,4381,4381,0,2004,1.0,0.0
9682,Between Us,4380,4380,0,2013,1.0,0.0
9683,The End of Time,4375,4375,0,2013,1.0,0.0
9684,The Woman Who Left,4373,3974,399,2017,0.9087582895037731,0.09124171049622684
9685,The Catechism Cataclysm,4373,4373,0,2011,1.0,0.0
9686,The Party's Just Beginning,4371,4145,226,2018,0.9482955845344315,0.05170441546556852
9687,The Flower of Kim Jong II,4362,4362,0,2010,1.0,0.0
9688,Tito and the Birds,4332,4332,0,2019,1.0,0.0
9689,On Meditation,4322,4322,0,2016,1.0,0.0
9690,Days of Grace 2015 Re-release,4308,4308,0,2015,1.0,0.0
9691,The Tower,4305,1117,3188,2014,0.259465737514518,0.740534262485482
9692,Auto Shop of Horrors,4300,4300,0,2016,1.0,0.0
9693,My Kingdom,4296,4296,0,2002,1.0,0.0
9694,The Fate of Lee Khan,4295,4295,0,2019,1.0,0.0
9695,Art Is... The Permanent Revolution,4291,4291,0,2012,1.0,0.0
9696,Brown's Requiem,4287,4287,0,2000,1.0,0.0
9697,State Like Sleep,4282,4282,0,2019,1.0,0.0
9698,Set Fire to the Stars,4280,4280,0,2015,1.0,0.0
9699,Jersey Guy,4268,4268,0,2003,1.0,0.0
9700,This Divided State,4255,4255,0,2005,1.0,0.0
9701,The Knife of Don Juan,4254,4254,0,2015,1.0,0.0
9702,My Father Die,4252,4252,0,2017,1.0,0.0
9703,Stella Does Tricks,4224,4224,0,2000,1.0,0.0
9704,Cocote,4224,3815,409,2018,0.9031723484848485,0.09682765151515152
9705,Maximum Ride,4218,4218,0,2016,1.0,0.0
9706,Stella's Last Weekend,4215,4215,0,2018,1.0,0.0
9707,Breaking a Monster,4212,4212,0,2016,1.0,0.0
9708,Free the Nipple,4198,4198,0,2014,1.0,0.0
9709,Helena from the Wedding,4190,4190,0,2010,1.0,0.0
9710,Among the Believers,4189,4189,0,2016,1.0,0.0
9711,3 Geezers!,4175,4175,0,2013,1.0,0.0
9712,Daylight,4171,4171,0,2011,1.0,0.0
9713,Melvin Goes to Dinner,4168,4168,0,2003,1.0,0.0
9714,Badsville,4153,4153,0,2017,1.0,0.0
9715,The Hillside Strangler,4143,4143,0,2004,1.0,0.0
9716,Pawn,4141,4141,0,2013,1.0,0.0
9717,Hera Purple,4123,4123,0,2002,1.0,0.0
9718,Stella Street,4119,4119,0,2004,1.0,0.0
9719,The Painting,4115,4115,0,2005,1.0,0.0
9720,Contracted,4105,4105,0,2013,1.0,0.0
9721,Ordinary Sinner,4083,4083,0,2003,1.0,0.0
9722,Jason Becker: Not Dead Yet,4080,1294,2786,2012,0.317156862745098,0.682843137254902
9723,Silver Circle,4080,4080,0,2013,1.0,0.0
9724,Three Night Stand,4076,4076,0,2015,1.0,0.0
9725,Bandido,4064,4064,0,2004,1.0,0.0
9726,The Kitchen,4054,4054,0,2013,1.0,0.0
9727,La Flor,4032,4032,0,2019,1.0,0.0
9728,Morning,4029,4029,0,2013,1.0,0.0
9729,Approved for Adoption 2013 Re-release,4015,4015,0,2013,1.0,0.0
9730,Yangsi,4008,4008,0,2012,1.0,0.0
9731,Pickin' & Grinnin',4000,4000,0,2012,1.0,0.0
9732,Campus Radio,4000,4000,0,2011,1.0,0.0
9733,Building Hope,4000,4000,0,2011,1.0,0.0
9734,Emily,3982,3982,0,2017,1.0,0.0
9735,Dream Boat,3981,3981,0,2017,1.0,0.0
9736,Armed,3948,3948,0,2018,1.0,0.0
9737,Just Say Love,3944,3944,0,2010,1.0,0.0
9738,"Blood, Friends and Money",3930,3930,0,2000,1.0,0.0
9739,Mother of a Day,3919,3919,0,2019,1.0,0.0
9740,Maidan,3909,3909,0,2014,1.0,0.0
9741,American Dresser,3895,3895,0,2018,1.0,0.0
9742,The Iron Ministry,3885,3340,545,2015,0.8597168597168597,0.1402831402831403
9743,Hollidaysburg,3861,3861,0,2014,1.0,0.0
9744,The Second Time Around,3837,3837,0,2018,1.0,0.0
9745,Aashayein,3836,0,3836,2010,0.0,1.0
9746,"High Tech, Low Life",3836,3836,0,2013,1.0,0.0
9747,Saints and Sinners,3826,3826,0,2004,1.0,0.0
9748,Free Radicals: A History of Experimental Film,3804,3804,0,2012,1.0,0.0
9749,My Wife Maurice 2004 Re-release,3803,3803,0,2004,1.0,0.0
9750,Wallflower,3801,3801,0,2019,1.0,0.0
9751,A Hole in My Heart,3784,3784,0,2005,1.0,0.0
9752,The Green Butchers,3783,3783,0,2004,1.0,0.0
9753,Bawandar,3779,3779,0,2003,1.0,0.0
9754,Unfreedom,3778,3778,0,2015,1.0,0.0
9755,They Come to America,3775,3775,0,2012,1.0,0.0
9756,Caravaggio,3774,3774,0,2002,1.0,0.0
9757,The Gender Card Flip,3774,3774,0,2017,1.0,0.0
9758,In/Significant Others,3763,3763,0,2010,1.0,0.0
9759,The Hollow,3755,3755,0,2016,1.0,0.0
9760,Nelly,3751,3751,0,2018,1.0,0.0
9761,Bugs,3742,3742,0,2017,1.0,0.0
9762,Big Animal,3733,3733,0,2004,1.0,0.0
9763,Bad Blood,3731,3731,0,2012,1.0,0.0
9764,The Free Speech Apocalypse,3726,3726,0,2015,1.0,0.0
9765,The Condemned,3718,3718,0,2013,1.0,0.0
9766,The Harvest/La Cosecha,3709,3709,0,2011,1.0,0.0
9767,The Helix... Loaded,3700,3700,0,2005,1.0,0.0
9768,Heartless,3697,3697,0,2010,1.0,0.0
9769,The Family,3696,3696,0,2018,1.0,0.0
9770,"Still, the Children Are Here",3685,3685,0,2004,1.0,0.0
9771,Brothers in Arms,3664,3664,0,2004,1.0,0.0
9772,Dr. Benny,3657,3657,0,2003,1.0,0.0
9773,The Word,3648,3648,0,2014,1.0,0.0
9774,Smash His Camera,3644,3644,0,2010,1.0,0.0
9775,Stop The Pounding Heart,3642,3642,0,2014,1.0,0.0
9776,The Wandering Soap Opera,3624,3624,0,2019,1.0,0.0
9777,Mr. Nobody 2013 Re-release,3622,3622,0,2013,1.0,0.0
9778,Warrior of Light,3617,3617,0,2003,1.0,0.0
9779,Moog,3604,3604,0,2004,1.0,0.0
9780,Cockfight,3600,3600,0,2004,1.0,0.0
9781,Journeys with George,3588,3588,0,2003,1.0,0.0
9782,Hyena,3586,3401,185,2015,0.9484104852203011,0.05158951477969883
9783,Hide Your Smiling Faces,3576,3576,0,2014,1.0,0.0
9784,Happy Here and Now,3574,3574,0,2005,1.0,0.0
9785,Evolution of a Criminal,3568,3568,0,2014,1.0,0.0
9786,The Last Film Festival,3558,3558,0,2016,1.0,0.0
9787,Fourplay,3550,3550,0,2018,1.0,0.0
9788,Sister Helen,3541,3541,0,2003,1.0,0.0
9789,La Belle Noiseuse 2017 Re-release,3540,3540,0,2017,1.0,0.0
9790,Tricked,3533,3533,0,2013,1.0,0.0
9791,The Loving Story 2016 Re-release,3518,3518,0,2016,1.0,0.0
9792,Revolution OS,3500,3500,0,2002,1.0,0.0
9793,Who's Crazy?,3497,3497,0,2017,1.0,0.0
9794,Locker 13,3496,3496,0,2014,1.0,0.0
9795,The Citizen 2018 Re-release,3495,3495,0,2018,1.0,0.0
9796,Dead Awake,3484,0,3484,2010,0.0,1.0
9797,"Love, Sweat and Tears",3482,3482,0,2017,1.0,0.0
9798,Metal Messiah,3476,3476,0,2010,1.0,0.0
9799,The Hacker Wars,3470,3470,0,2014,1.0,0.0
9800,The Full Picture,3467,3467,0,2010,1.0,0.0
9801,Short Eyes,3456,3456,0,2003,1.0,0.0
9802,Aftermath,3451,3451,0,2014,1.0,0.0
9803,Life's a Breeze 2014 Re-release,3450,3450,0,2014,1.0,0.0
9804,Grand Theft Parsons,3438,0,3438,2004,0.0,1.0
9805,Scenic Route,3434,3434,0,2013,1.0,0.0
9806,Mahogany Sunrise,3432,3432,0,2014,1.0,0.0
9807,Restored Me 2016 Re-release,3428,3428,0,2016,1.0,0.0
9808,Speed Sisters,3423,3423,0,2017,1.0,0.0
9809,The Happy Poet,3400,3400,0,2013,1.0,0.0
9810,The Cage Fighter,3392,3392,0,2018,1.0,0.0
9811,Tamala 2010: A Punk Cat in Space,3386,3386,0,2004,1.0,0.0
9812,Rottentail,3383,3383,0,2019,1.0,0.0
9813,Amanda & Jack Go Glamping,3352,3352,0,2017,1.0,0.0
9814,Bad Match,3351,3351,0,2017,1.0,0.0
9815,Followers,3350,3350,0,2018,1.0,0.0
9816,Fashion Victim,3346,3346,0,2010,1.0,0.0
9817,Swerve,3338,3338,0,2013,1.0,0.0
9818,Mi America,3330,3330,0,2015,1.0,0.0
9819,Know How,3323,3323,0,2015,1.0,0.0
9820,Drunk Wedding,3301,3301,0,2015,1.0,0.0
9821,Looking Through Lillian,3300,3300,0,2002,1.0,0.0
9822,Burning Bodhi,3289,3289,0,2016,1.0,0.0
9823,Axe Giant: The Wrath of Paul Bunyan,3287,3287,0,2013,1.0,0.0
9824,El Superstar: The Unlikely Rise of Juan Frances,3271,3271,0,2010,1.0,0.0
9825,I Love Your Work,3264,3264,0,2005,1.0,0.0
9826,Justice,3259,3259,0,2017,1.0,0.0
9827,Windsor Drive,3256,3256,0,2015,1.0,0.0
9828,Sex Sells: The Making of 'Touché',3252,3252,0,2005,1.0,0.0
9829,Over the Limit,3243,3243,0,2018,1.0,0.0
9830,The Sons of Tennessee Williams,3242,3242,0,2011,1.0,0.0
9831,As Cool as I Am,3234,3234,0,2013,1.0,0.0
9832,The Work and the Story,3233,3233,0,2003,1.0,0.0
9833,Blackhats,3216,3216,0,2015,1.0,0.0
9834,A Cuban Legend,3212,3212,0,2002,1.0,0.0
9835,The Backyard,3200,3200,0,2003,1.0,0.0
9836,After the Wizard,3184,3184,0,2012,1.0,0.0
9837,Apart,3161,3161,0,2012,1.0,0.0
9838,Game Changers,3142,3142,0,2018,1.0,0.0
9839,Balls to the Wall,3140,3140,0,2011,1.0,0.0
9840,Hot to Trot,3133,3133,0,2018,1.0,0.0
9841,The Girl on the Train,3124,3124,0,2014,1.0,0.0
9842,Nowhere Man,3105,3105,0,2005,1.0,0.0
9843,Showrunners: The Art of Running a TV Show,3100,3100,0,2014,1.0,0.0
9844,What Now? Remind Me,3089,3089,0,2014,1.0,0.0
9845,Drew: The Man Behind the Poster,3078,3078,0,2013,1.0,0.0
9846,Chasing Portraits,3076,3076,0,2019,1.0,0.0
9847,The Weird World of Blowfly,3062,3062,0,2011,1.0,0.0
9848,The Afterlight,3059,3059,0,2010,1.0,0.0
9849,Unveiled,3025,3025,0,2005,1.0,0.0
9850,A French Gigolo 2014 Re-release,3021,3021,0,2014,1.0,0.0
9851,A Girl and a Gun,3018,3018,0,2013,1.0,0.0
9852,Best and Most Beautiful Things,3016,3016,0,2016,1.0,0.0
9853,15,3013,3013,0,2005,1.0,0.0
9854,Fatal Assistance,3000,3000,0,2014,1.0,0.0
9855,The Ghosts of Johnson Woods,3000,3000,0,2016,1.0,0.0
9856,The Lie,3000,3000,0,2011,1.0,0.0
9857,Zokkomon,3000,3000,0,2011,1.0,0.0
9858,Stolen Childhoods,2996,2996,0,2005,1.0,0.0
9859,Moana,2993,2993,0,2015,1.0,0.0
9860,Tattoo Bar,2964,2964,0,2002,1.0,0.0
9861,Ash Wednesday,2942,2942,0,2002,1.0,0.0
9862,Kepler's Dream,2923,2923,0,2017,1.0,0.0
9863,Demons,2900,2900,0,2017,1.0,0.0
9864,The Professor: Tai Chi's Journey West,2852,2852,0,2016,1.0,0.0
9865,Three Days of Rain,2841,2841,0,2005,1.0,0.0
9866,Okraina,2797,2797,0,2004,1.0,0.0
9867,Approaching Midnight,2795,2795,0,2013,1.0,0.0
9868,Nana,2784,2784,0,2018,1.0,0.0
9869,Lush,2763,2763,0,2001,1.0,0.0
9870,Blood Ties,2760,2760,0,2011,1.0,0.0
9871,White Lies 2016 Re-release,2760,2760,0,2016,1.0,0.0
9872,I Dream in Another Language,2739,2739,0,2017,1.0,0.0
9873,Black Out 2014 Re-release,2734,2734,0,2014,1.0,0.0
9874,The Lesser Blessed,2732,2732,0,2013,1.0,0.0
9875,Chocolat 2015 Re-release,2710,2710,0,2015,1.0,0.0
9876,Julia,2710,2710,0,2015,1.0,0.0
9877,Adolf Eichmann,2706,2706,0,2010,1.0,0.0
9878,Back to the Fatherland,2697,2697,0,2019,1.0,0.0
9879,The Boys in the Band 2000 Re-release,2695,2695,0,2000,1.0,0.0
9880,Straight Into a Storm,2684,2684,0,2018,1.0,0.0
9881,Santoalla,2684,2684,0,2017,1.0,0.0
9882,Division 19,2680,1699,981,2019,0.633955223880597,0.366044776119403
9883,Restitution,2664,2664,0,2011,1.0,0.0
9884,United Red Army 2011 Re-release,2659,2659,0,2011,1.0,0.0
9885,Daughter of the Nile,2640,2640,0,2017,1.0,0.0
9886,Body,2634,2634,0,2015,1.0,0.0
9887,Refuge,2631,2631,0,2014,1.0,0.0
9888,ACORN and the Firestorm,2621,2621,0,2018,1.0,0.0
9889,Indigo Children,2621,2621,0,2014,1.0,0.0
9890,The Child I Never Was,2609,2609,0,2004,1.0,0.0
9891,Sparrows Dance,2602,2602,0,2013,1.0,0.0
9892,Conspiracy of Silence,2598,2598,0,2004,1.0,0.0
9893,Last Flight of the Champion,2597,2597,0,2013,1.0,0.0
9894,Carl,2592,2592,0,2012,1.0,0.0
9895,Jake Squared,2592,2592,0,2014,1.0,0.0
9896,Dead or Alive: Final,2591,2591,0,2002,1.0,0.0
9897,Hammer of the Gods,2590,641,1949,2013,0.24749034749034748,0.7525096525096525
9898,Take Me,2583,2583,0,2017,1.0,0.0
9899,McCanick,2572,2572,0,2014,1.0,0.0
9900,Hayride 2,2571,2571,0,2015,1.0,0.0
9901,Joan the Maid 1: The Battles,2562,2562,0,2019,1.0,0.0
9902,Ginger Snaps,2554,2554,0,2001,1.0,0.0
9903,Cassadaga,2544,2544,0,2013,1.0,0.0
9904,Whatever Happened to Harold Smith?,2543,2543,0,2001,1.0,0.0
9905,Two-Bit Waltz,2540,2540,0,2014,1.0,0.0
9906,Miles,2537,2537,0,2017,1.0,0.0
9907,Risk/Reward,2517,2517,0,2004,1.0,0.0
9908,Almost in Love,2510,2510,0,2013,1.0,0.0
9909,Swing,2509,2509,0,2004,1.0,0.0
9910,Mekong Hotel,2502,2502,0,2016,1.0,0.0
9911,Standing by Yourself,2500,2500,0,2002,1.0,0.0
9912,L'autre monde 2004 Re-release,2494,2494,0,2004,1.0,0.0
9913,The Last Day of August,2492,2492,0,2013,1.0,0.0
9914,Homeland (Iraq Year Zero),2491,2491,0,2016,1.0,0.0
9915,Men at Lunch,2483,2483,0,2013,1.0,0.0
9916,The Wait,2480,2480,0,2014,1.0,0.0
9917,TINY: The Life of Erin Blackwell,2465,2465,0,2019,1.0,0.0
9918,Motocross Kids,2462,2462,0,2004,1.0,0.0
9919,The Ghastly Love of Johnny X,2436,2436,0,2012,1.0,0.0
9920,Why Stop Now?,2432,2432,0,2012,1.0,0.0
9921,The Reflektor Tapes,2424,0,2424,2015,0.0,1.0
9922,Firedancer,2422,2422,0,2004,1.0,0.0
9923,L.A. Slasher,2421,2421,0,2015,1.0,0.0
9924,Zig Zag,2418,2418,0,2002,1.0,0.0
9925,Ek Hazarachi Note,2404,2404,0,2016,1.0,0.0
9926,The Optimists,2377,2377,0,2005,1.0,0.0
9927,Daniel and Ana,2372,2372,0,2010,1.0,0.0
9928,Evergreen: The Road to Legalization,2363,2363,0,2014,1.0,0.0
9929,I Lost Albert 2019 Re-release,2354,2354,0,2019,1.0,0.0
9930,A German Youth,2343,2343,0,2019,1.0,0.0
9931,Lotus Eaters,2325,2325,0,2013,1.0,0.0
9932,The Happy House,2311,2311,0,2013,1.0,0.0
9933,Serendipity,2298,2298,0,2019,1.0,0.0
9934,The Girl 2010 Re-release,2273,2201,72,2010,0.9683238011438627,0.03167619885613726
9935,The Pool Boys,2269,2269,0,2011,1.0,0.0
9936,Red Christmas,2255,2255,0,2017,1.0,0.0
9937,Anita Ho,2250,2250,0,2015,1.0,0.0
9938,Memoria,2242,2242,0,2016,1.0,0.0
9939,You Wont Miss Me,2240,2240,0,2010,1.0,0.0
9940,Virgil Bliss,2219,2219,0,2002,1.0,0.0
9941,The Night Watchman,2219,2219,0,2012,1.0,0.0
9942,Side Effects,2216,2216,0,2005,1.0,0.0
9943,7 from Etheria,2208,2208,0,2017,1.0,0.0
9944,InSpectres,2207,2207,0,2013,1.0,0.0
9945,Scorn,2206,2206,0,2012,1.0,0.0
9946,Dischord,2199,2199,0,2003,1.0,0.0
9947,Hell's Highway: The True Story of Highway Safety Films,2171,2171,0,2003,1.0,0.0
9948,The 4th Tenor,2152,2152,0,2002,1.0,0.0
9949,Stripped,2151,2151,0,2002,1.0,0.0
9950,Better Living,2147,2147,0,2000,1.0,0.0
9951,Stealing the Fire,2139,2139,0,2002,1.0,0.0
9952,NoBody's Perfect 2010 Re-release,2122,2122,0,2010,1.0,0.0
9953,Missionary,2120,2120,0,2014,1.0,0.0
9954,Me You and Five Bucks,2105,2105,0,2015,1.0,0.0
9955,Jihadists,2104,2104,0,2019,1.0,0.0
9956,Dayveon,2077,2077,0,2017,1.0,0.0
9957,Red Flag,2075,2075,0,2013,1.0,0.0
9958,Rubberneck,2075,2075,0,2013,1.0,0.0
9959,Patagonia Rising,2064,2064,0,2012,1.0,0.0
9960,Some Body,2042,2042,0,2002,1.0,0.0
9961,Choice of Weapons,2032,2032,0,2002,1.0,0.0
9962,Algorithms,2021,2021,0,2014,1.0,0.0
9963,Split: A Deeper Divide,2000,2000,0,2012,1.0,0.0
9964,Enemies of Laughter,2000,2000,0,2003,1.0,0.0
9965,The Watermelon Woman,1989,1989,0,2016,1.0,0.0
9966,Falling Awake,1978,1978,0,2010,1.0,0.0
9967,Steal Me,1967,1967,0,2005,1.0,0.0
9968,The Temptation of St. Tony,1963,1963,0,2010,1.0,0.0
9969,"Accidental Courtesy: Daryl Davis, Race & America",1940,1940,0,2017,1.0,0.0
9970,Best Man Down,1938,1938,0,2013,1.0,0.0
9971,West Of The Jordan River,1926,1926,0,2018,1.0,0.0
9972,A Mother's Courage: Talking Back to Autism 2010 Re-release,1916,1916,0,2010,1.0,0.0
9973,Mr. Smith Gets a Hustler,1915,1915,0,2002,1.0,0.0
9974,Sneakerheadz,1903,1903,0,2015,1.0,0.0
9975,With God on Our Side: George W. Bush and the Rise of the Religious Right in America,1884,1884,0,2005,1.0,0.0
9976,We Were Here,1873,0,1873,2011,0.0,1.0
9977,She's One of Us 2005 Re-release,1870,1870,0,2005,1.0,0.0
9978,Finding Happiness,1841,1841,0,2018,1.0,0.0
9979,Jimi Hendrix Electric Church,1818,0,1818,2019,0.0,1.0
9980,Now & Later,1808,1808,0,2011,1.0,0.0
9981,By Hook or by Crook,1802,1802,0,2002,1.0,0.0
9982,The Opera Lover,1798,1798,0,2002,1.0,0.0
9983,I Kissed a Vampire,1794,1794,0,2012,1.0,0.0
9984,Detour,1788,1788,0,2017,1.0,0.0
9985,The Lost Village,1780,1780,0,2018,1.0,0.0
9986,Detention of the Dead,1777,1777,0,2013,1.0,0.0
9987,The Other Man: F.W. de Klerk and the End of Apartheid,1747,1747,0,2015,1.0,0.0
9988,Dark Forest,1739,1739,0,2015,1.0,0.0
9989,You Don't Need Feet to Dance,1719,1719,0,2013,1.0,0.0
9990,Das Boot ist voll 2005 Re-release,1718,1718,0,2005,1.0,0.0
9991,The Road to Love,1714,1714,0,2004,1.0,0.0
9992,A Beautiful Now,1714,1714,0,2016,1.0,0.0
9993,The Looking Glass,1711,1711,0,2015,1.0,0.0
9994,Dystopia: 2013,1708,1708,0,2012,1.0,0.0
9995,Marathon,1703,1703,0,2004,1.0,0.0
9996,More Than the Rainbow,1677,1677,0,2014,1.0,0.0
9997,Persons of Interest,1672,1672,0,2004,1.0,0.0
9998,They're Out of the Business,1655,1655,0,2011,1.0,0.0
9999,Drown,1631,1631,0,2015,1.0,0.0
10000,Cut Snake,1625,1625,0,2015,1.0,0.0
10001,Game Day,1624,1624,0,2019,1.0,0.0
10002,Rockets Redglare!,1605,1605,0,2004,1.0,0.0
10003,Blindness,1602,1602,0,2003,1.0,0.0
10004,Miss India America,1598,1598,0,2016,1.0,0.0
10005,Forever,1598,1598,0,2015,1.0,0.0
10006,Pups,1590,1590,0,2000,1.0,0.0
10007,Manuela and Manuel,1582,1582,0,2010,1.0,0.0
10008,Mama Africa,1581,1581,0,2002,1.0,0.0
10009,Wash Dry and Spin Out,1570,1570,0,2003,1.0,0.0
10010,What Boys Like,1554,1554,0,2004,1.0,0.0
10011,Independent Spirits: Faith Hubley/John Hubley,1551,1551,0,2003,1.0,0.0
10012,The Tunnel,1532,1532,0,2011,1.0,0.0
10013,Rhymes for Young Ghouls,1529,1529,0,2014,1.0,0.0
10014,"Carmo, Hit the Road 2010 Re-release",1512,1512,0,2010,1.0,0.0
10015,Blackwoods,1500,1500,0,2002,1.0,0.0
10016,Souldier,1500,1500,0,2014,1.0,0.0
10017,Making Grace,1496,1496,0,2005,1.0,0.0
10018,Where Are You Taking Me?,1492,1492,0,2012,1.0,0.0
10019,Making Rounds,1484,1484,0,2015,1.0,0.0
10020,Heartbreak Hospital,1480,1480,0,2002,1.0,0.0
10021,The Letter: An American Town and the 'Somali Invasion',1479,1479,0,2005,1.0,0.0
10022,Henchmen,1469,1469,0,2018,1.0,0.0
10023,The Package,1469,1469,0,2013,1.0,0.0
10024,That Way Madness Lies...,1447,1447,0,2018,1.0,0.0
10025,The Ballad of Bering Strait,1440,1440,0,2003,1.0,0.0
10026,Kalyug,1435,1435,0,2005,1.0,0.0
10027,Monumental: David Brower's Fight for Wild America,1430,1430,0,2005,1.0,0.0
10028,Bestiaire,1428,1428,0,2012,1.0,0.0
10029,The Silence of Mark Rothko,1422,1422,0,2016,1.0,0.0
10030,Shwaas,1416,1416,0,2004,1.0,0.0
10031,The Forest for the Trees,1410,1410,0,2017,1.0,0.0
10032,Drool,1403,1403,0,2010,1.0,0.0
10033,"Love, Honor and Obey",1400,1400,0,2001,1.0,0.0
10034,The Execution of Wanda Jean,1386,1386,0,2002,1.0,0.0
10035,Besotted,1379,1379,0,2002,1.0,0.0
10036,Beauty and the Beholder,1368,1368,0,2018,1.0,0.0
10037,Along the Roadside 2015 Re-release,1352,1352,0,2015,1.0,0.0
10038,Return to the Land of Wonders,1338,1338,0,2005,1.0,0.0
10039,El Leyton,1332,1332,0,2003,1.0,0.0
10040,Exorcism,1303,1303,0,2003,1.0,0.0
10041,3 Nights in the Desert,1297,1297,0,2015,1.0,0.0
10042,The Hours and Times,1273,1273,0,2019,1.0,0.0
10043,Altered Perception,1259,1259,0,2018,1.0,0.0
10044,Proteus: A Nineteenth Century Vision,1246,1246,0,2005,1.0,0.0
10045,Two Men Went to War 2018 Re-release,1227,1227,0,2018,1.0,0.0
10046,A Small Good Thing,1196,1196,0,2016,1.0,0.0
10047,Snowman's Land,1190,1190,0,2012,1.0,0.0
10048,Under the Turban,1190,1190,0,2018,1.0,0.0
10049,Above and Below,1189,0,1189,2016,0.0,1.0
10050,A Different American Dream,1172,1172,0,2017,1.0,0.0
10051,A Zombie Invasion,1170,1170,0,2013,1.0,0.0
10052,Jack & Diane,1142,1142,0,2012,1.0,0.0
10053,Veer!,1132,1132,0,2013,1.0,0.0
10054,Half Brothers,1100,1100,0,2018,1.0,0.0
10055,We Are the Giant,1088,1088,0,2014,1.0,0.0
10056,The Butterfly Room,1081,1081,0,2014,1.0,0.0
10057,Childless,1036,1036,0,2015,1.0,0.0
10058,Invisible Hands,1034,1034,0,2018,1.0,0.0
10059,Absence,1031,1031,0,2013,1.0,0.0
10060,Remnants,1022,1022,0,2013,1.0,0.0
10061,The Jimmy Show,1000,1000,0,2002,1.0,0.0
10062,A House on a Hill,984,984,0,2003,1.0,0.0
10063,The Penguin Counters,976,976,0,2017,1.0,0.0
10064,Strangers Online,968,968,0,2011,1.0,0.0
10065,The Last Wave 2001 Re-release,957,957,0,2001,1.0,0.0
10066,The Lonely Affair of the Heart,932,932,0,2002,1.0,0.0
10067,A People Uncounted,930,930,0,2014,1.0,0.0
10068,They Are We,900,900,0,2015,1.0,0.0
10069,Big Muddy,881,881,0,2015,1.0,0.0
10070,Extraordinary Ordinary People,880,880,0,2017,1.0,0.0
10071,800 Bullets 2004 Re-release,866,866,0,2004,1.0,0.0
10072,45365,853,853,0,2010,1.0,0.0
10073,Officer Downe,850,850,0,2016,1.0,0.0
10074,Abandoned,832,832,0,2011,1.0,0.0
10075,TVTV: Video Revolutionaries,812,812,0,2018,1.0,0.0
10076,Jackpot 2014 Re-release,806,806,0,2014,1.0,0.0
10077,The Untold Story,790,790,0,2019,1.0,0.0
10078,It's All So Quiet 2015 Re-release,724,724,0,2015,1.0,0.0
10079,A Girl Like Grace,713,713,0,2016,1.0,0.0
10080,Redneck Carnage,706,706,0,2011,1.0,0.0
10081,The Loving Story,700,700,0,2012,1.0,0.0
10082,It's Hard Being Loved by Jerks 2015 Re-release,697,697,0,2015,1.0,0.0
10083,The Portal,685,0,685,2019,0.0,1.0
10084,Syrup,663,663,0,2013,1.0,0.0
10085,Nature Calls,646,646,0,2012,1.0,0.0
10086,Spooky House 2005 Re-release,637,637,0,2005,1.0,0.0
10087,Citizen Gangster,625,625,0,2012,1.0,0.0
10088,Steve + Sky,624,624,0,2005,1.0,0.0
10089,Anatomy 2 2004 Re-release,623,623,0,2004,1.0,0.0
10090,"Jesus, You Know",604,604,0,2004,1.0,0.0
10091,Gottfried Helnwein and the Dreaming Child,601,601,0,2012,1.0,0.0
10092,Shake Hands with the Devil,594,594,0,2010,1.0,0.0
10093,Sorority Girls' Revenge,582,582,0,2001,1.0,0.0
10094,A Good Day to Die,573,573,0,2011,1.0,0.0
10095,The Pit,560,560,0,2016,1.0,0.0
10096,The Comedians of Comedy,549,549,0,2005,1.0,0.0
10097,Higher Power,528,528,0,2018,1.0,0.0
10098,Meeting Evil,525,525,0,2012,1.0,0.0
10099,The 11th Hour,510,0,510,2015,0.0,1.0
10100,Tasuma,479,479,0,2004,1.0,0.0
10101,Triumph of the Wall,476,476,0,2013,1.0,0.0
10102,Green is Gold,455,455,0,2016,1.0,0.0
10103,The Dark Hours,423,423,0,2005,1.0,0.0
10104,The Magician 2010 Re-release,406,406,0,2010,1.0,0.0
10105,Skinless,400,400,0,2014,1.0,0.0
10106,Cinemanovels,398,398,0,2014,1.0,0.0
10107,Antiporno,294,0,294,2017,0.0,1.0
10108,"Mummy, I'm A Zombie",120,120,0,2014,1.0,0.0
10109,Paranoid Girls,78,78,0,2015,1.0,0.0
10110,Confession of a Child of the Century 2015 Re-release,74,74,0,2015,1.0,0.0
